content_en	content_ko
Let go of your attachment to the outcome.	당신의 결과에 대한 집착을 버리세요.
Do I seem like a morning person or a night owl? Why?	나는 아침형 인간 같나요, 저녁형 인간 같나요? 왜 그렇죠?
Write down something others would never guess about you just by looking at you. (Both players) compare.	다른 사람들이 겉모습만 보고는 절대 알 수 없는 것을 적어보세요. (양쪽 플레이어) 비교하세요.
Ask and answer the next question in a different accent (Both players).	다음 질문을 다른 억양으로 묻고 답하세요. (양쪽 플레이어)
What do my shoes tell you about me?	내 신발이 나에 대해 무엇을 말해주나요?
Do you think I've ever been fired from a job? If so, what for?	내가 직장에서 해고된 적이 있을 것 같나요? 그렇다면 왜 그렇죠?
Think of your favorite childhood TV show of all time. On the count of three, say it out loud! (Both players)	어린 시절 가장 좋아했던 TV 프로그램을 떠올려 보세요. 셋을 셀 때 큰 소리로 말하세요! (양쪽 플레이어)
Do I look kind? Explain.	내가 친절해 보이나요? 설명해 주세요.
Who do you think my celebrity crush is?	내가 좋아하는 연예인이 누구라고 생각하나요?
Do I seem like more of a creative or analytical type? Explain.	나는 창의적인 사람 같나요, 분석적인 사람 같나요? 설명해 주세요.
Do you think I intimidate others? Why or why not?	내가 다른 사람들을 겁주나요? 왜 그렇죠? 왜 그렇지 않나요?
What fast food restaurant do you think I'm most likely to drive through? What's my order?	내가 가장 자주 방문할 것 같은 패스트푸드 레스토랑은 어디일까요? 내가 무엇을 주문할까요?
Draw a portrait of each other to the best of your ability. (1 minute) Then exchange.	서로의 초상화를 최대한 그려보세요. (1분) 그런 다음 교환하세요.
Do you think I've ever checked an ex's phone for evidence?	내가 전 남자친구/여자친구의 휴대폰을 증거를 찾기 위해 확인해 본 적이 있을 것 같나요?
Close your eyes. What color is my shirt?	눈을 감아보세요. 내 셔츠 색깔은 무엇인가요?
Close your eyes. What color are my eyes?	눈을 감아보세요. 내 눈 색깔은 무엇인가요?
Rate your dancing skills on a scale of 1-10. On the count of three, say your answers out loud! (Both players)	당신의 춤 실력을 1-10점 척도로 평가해보세요. 셋을 셀 때 큰 소리로 답을 외치세요! (양쪽 플레이어)
Do you think I fall in love easily? Why or why not?	나는 쉽게 사랑에 빠질 것 같나요? 왜 그렇죠? 왜 그렇지 않나요?
What's the first thing you noticed about me?	내가 가장 먼저 본 것은 무엇인가요?
How many speeding tickets do you think I've gotten in my life?	내가 지금까지 몇 번의 과속 딱지를 받았을 것 같나요?
How likely am I to go camping? How high maintenance is my setup?	내가 캠핑을 갈 가능성이 얼마나 될 것 같나요? 내 캠핑 장비는 얼마나 고급일까요?
What is my body language telling you right now?	내 몸짓이 지금 무엇을 말해주고 있나요?
As a child, what do you think I wanted to be?	어릴 때, 나는 무엇이 되고 싶어했을 것 같나요?
Do I seem like a coffee or tea person? Sweetened or unsweetened?	나는 커피를 좋아할 것 같나요, 차를 좋아할 것 같나요? 설탕을 넣은 것, 넣지 않은 것?
Do I seem like someone who would get name tattooed on myself? Why or why not?	내가 내 이름을 문신으로 새길 사람 같나요? 왜 그렇죠? 왜 그렇지 않나요?
What was your first impression of me?	나에 대한 첫인상은 어땠나요?
Make an assumption about me. (Both players)	나에 대해 가정을 해보세요. (양쪽 플레이어)
What does my instagram tell you about me?	내 인스타그램이 나에 대해 무엇을 말해주나요?
Do you think I'm usually early, on time, or late to events? Explain.	나는 보통 일찍 도착하나요, 제시간에 도착하나요, 아니면 늦게 도착하나요? 설명해 주세요.
Draw a picture together. (30 seconds)	함께 그림을 그리세요. (30초)
What do you think I'm most likely to splurge on?	내가 가장 사치할 것 같은 것은 무엇인가요?
What do you think is the hardest part of what I do for a living?	내 직업에서 가장 어려운 부분은 무엇일까요?
What about me is most strange or familiar to you?	나에 대해 가장 이상한 점이나 가장 익숙한 점은 무엇인가요?
Do you think plants thrive or die in my care? Explain.	내가 식물을 잘 키울 것 같나요, 죽일 것 같나요? 설명해 주세요.
Think of your favorite brand of cereal. On the count of three, say your answers out loud! (Both players)	당신이 가장 좋아하는 시리얼 브랜드를 떠올려 보세요. 셋을 셀 때 큰 소리로 답을 외치세요! (양쪽 플레이어)
What do you think my go to karaoke song is?	내가 가장 자주 부를 것 같은 노래방 곡은 무엇인가요?
Finish the sentence: just by looking at you I'd think _______.	문장을 완성하세요: 당신을 보고 나는 _______라고 생각할 것입니다.
What reality show do you think I'm most likely to binge watch? Explain.	내가 가장 좋아할 것 같은 리얼리티 쇼는 무엇일까요? 설명해 주세요.
What about me intrigues you?	나에 대해 무엇이 궁금한가요?
On a scale of 1-10, how messy do you think my car is? 1 being cleanest, 10 a complete disaster. Explain.	내 차가 얼마나 지저분할 것 같나요? 1점은 가장 깨끗한 상태, 10점은 완전 엉망인 상태. 설명해 주세요.
What subject do you think I thrived in at school? Did I fail any?	내가 학교에서 잘했던 과목은 무엇일 것 같나요? 실패한 과목은 있나요?
If you were to buy me a present, knowing nothing about me other than what I look like, what would it be?	나를 전혀 모른 채 내가 좋아할 만한 선물을 사야 한다면, 무엇을 사겠습니까?
What character would I play in a movie?	영화에서 내가 연기할 캐릭터는 누구일까요?
Do I seem like a cat or dog person?	나는 고양이를 좋아할 것 같나요, 개를 좋아할 것 같나요?
If myspace were still a thing, what would my profile song be?	마이스페이스가 아직도 존재한다면, 내 프로필 송은 무엇일까요?
Do you think I was popular in school? Explain.	내가 학교에서 인기가 있었을 것 같나요? 설명해 주세요.
What compliment do you think I hear the most?	내가 가장 많이 듣는 칭찬은 무엇일 것 같나요?
What does my phone wallpaper tell you about me?	내 휴대폰 배경화면이 나에 대해 무엇을 말해주나요?
Do I remind you of anyone?	내가 누구를 떠올리게 하나요?
Maintain eye contact for thirty seconds. What did you notice?	30초 동안 눈을 마주치세요. 무엇을 느꼈나요?
Describe your perfect day!	당신의 완벽한 하루를 설명하세요!
When you're asked how are you, how often do you answer truthfully?	어떻게 지내냐는 질문에 얼마나 자주 진실하게 대답하나요?
Have you changed your mind about anything recently?	최근에 생각을 바꾼 것이 있나요?
How are you, really?	정말로, 어떻게 지내세요?
Draw your current mood. Then compare. (Both players)	당신의 현재 기분을 그려보세요. 그런 다음 비교하세요. (양쪽 플레이어)
Has a stranger ever changed your life?	낯선 사람이 당신의 인생을 바꾼 적이 있나요?
What's been the best compliment a stranger has ever given you?	낯선 사람이 준 최고의 칭찬은 무엇인가요?
Press shuffle on your music library. Explain the first song that comes up!	음악 라이브러리를 셔플해 보세요. 첫 번째로 나오는 노래를 설명해 주세요!
What is a compliment you wish you received more frequently?	더 자주 받고 싶은 칭찬은 무엇인가요?
What title would you give this chapter in your life?	이 인생의 장에 제목을 붙인다면 무엇일까요?
Sing the chorus of your favorite song of all time. Get into it!	당신이 가장 좋아하는 노래의 후렴구를 불러보세요. 신나게!
What is something you wouldn't want to change about yourself?	당신에 대해 바꾸고 싶지 않은 것은 무엇인가요?
What do you crave more of?	무엇을 더 갈망하나요?
What would your younger self not believe about your life today?	당신의 어린 자아가 오늘의 당신의 삶을 믿지 못할 것은 무엇일까요?
What question are you trying to answer most in your life right now?	지금 당신의 인생에서 가장 답을 찾고 있는 질문은 무엇인가요?
What has been your earliest recollection of happiness?	가장 이른 행복의 기억은 무엇인가요?
Both players write an embarrassing fun fact about yourselves. Play a game of rock, paper, scissors. Loser must reveal!	양쪽 플레이어가 자신에 대한 민망한 재미있는 사실을 적으세요. 가위바위보를 하세요. 지는 사람은 공개해야 합니다!
Finish the sentences: Strangers would describe me as _______. Only I know that I am _______.	문장을 완성하세요: 낯선 사람들은 나를 _______라고 묘사할 것입니다. 나는 _______라는 것을 알고 있습니다.
Create a secret handshake!	비밀 악수를 만들어보세요!
What is the most unexplainable thing that's ever happened to you?	당신에게 가장 설명할 수 없는 일은 무엇인가요?
Be more interested in understanding others than being understood.	이해받는 것보다 다른 사람을 이해하는 데 더 관심을 가지세요.
What is the last thing you lied to your mother about?	마지막으로 어머니에게 거짓말한 것은 무엇인가요?
What are you still trying to prove to yourself?	아직도 자신에게 증명하려고 하는 것은 무엇인가요?
Swap seats with your partner.	파트너와 자리를 바꾸세요.
What are you more afraid of, failure or success? And why?	실패와 성공 중 무엇이 더 두렵나요? 왜 그렇죠?
Have you ever told someone I love you but didn't mean it? If so, why?	사랑한다는 말을 했지만 진심이 아니었던 적이 있나요? 그렇다면 왜 그렇죠?
What's your mother's name? And the most beautiful thing about her?	어머니의 이름은 무엇인가요? 그녀에 대해 가장 아름다운 점은 무엇인가요?
Do you think the image you have of yourself matches the image people see you as?	당신이 자신에 대해 가지고 있는 이미지가 사람들이 보는 이미지와 일치한다고 생각하나요?
What's your father's name? And tell me one thing about him.	아버지의 이름은 무엇인가요? 그에 대해 한 가지를 말해 주세요.
Admit something.	무언가를 고백해 보세요.
Staring contest. First to blink must reveal a personal problem and ask your partner for advice on how they might handle it.	눈싸움 대결. 먼저 눈을 깜빡이는 사람이 개인적인 문제를 공개하고 파트너에게 그 문제를 해결하는 방법에 대한 조언을 요청하세요.
If you have, when was the moment you realized you weren't invincible?	당신이 해냈다면, 당신이 무적이 아니었다는 것을 깨달은 순간은 언제인가요?
Both players write the three most important things in life to you. (30 seconds) Compare.	양쪽 플레이어가 인생에서 가장 중요한 세 가지를 적으세요. (30초) 비교하세요.
How can you become a better person?	어떻게 하면 더 나은 사람이 될 수 있을까요?
If you could get to know someone in your life on a deeper level, who would it be and why?	당신의 인생에서 더 깊이 알고 싶은 사람이 있다면 누구이며, 왜 그렇죠?
Think of something you strongly dislike that most people love. On the count of three say it out loud! (Both players)	대부분의 사람들이 사랑하는 것을 강하게 싫어하는 것을 생각해 보세요. 셋을 셀 때 큰 소리로 말하세요! (양쪽 플레이어)
How would you describe the feeling of being in love in one word?	사랑에 빠진다는 느낌을 한 단어로 표현해 보세요.
What's the most pain you've ever been in that wasn't physical?	육체적이지 않은 가장 큰 고통은 무엇이었나요?
What lesson took you the longest to unlearn?	가장 오랫동안 배워야 했던 교훈은 무엇인가요?
When was the last time you surprised yourself?	마지막으로 자신에게 놀란 적은 언제인가요?
Ask a question you'd be too afraid to ask. Something you wouldn't dare to ask.	질문을 한 가지 해보세요. 두려워서 묻지 못했던 질문.
What part of your life works? What part of your life hurts?	당신의 인생에서 무엇이 잘 되고 있나요? 무엇이 아픈가요?
Show the first photo in your camera roll. Explain.	휴대폰 카메라 롤에서 첫 번째 사진을 보여주세요. 설명해 주세요.
Are you missing anyone right now? Do you think they are missing you too?	지금 그리운 사람이 있나요? 그 사람도 당신을 그리워하고 있다고 생각하나요?
What is your 1st love's name and the reason you fell in love with him/her?	당신의 첫사랑의 이름은 무엇이며, 그 사람과 사랑에 빠진 이유는 무엇이었나요?
What's been your happiest memory this part year?	올해 가장 행복한 기억은 무엇인가요?
What is a dream you've let go of?	포기한 꿈은 무엇인가요?
Questions are an art form. Create your own question.	질문은 예술의 형태입니다. 자신만의 질문을 만들어보세요.
Is there a feeling you miss?	그리워하는 감정이 있나요?
Call someone you admire and tell them why you appreciate them! (Put on speaker phone)	존경하는 사람에게 전화해서 왜 그들을 존경하는지 말해 주세요! (스피커폰을 켜세요)
Are you lying to yourself about anything?	자신에게 어떤 거짓말을 하고 있나요?
If you could have it your way: who would be with? Where would you be? & What would you be doing?	당신의 방식대로: 누구와 함께 있고 싶나요? 어디에 있고 싶나요? 그리고 무엇을 하고 싶나요?
Do you believe everyone has a calling? If so, do you think I've found mine?	모든 사람에게 소명이 있다고 생각하나요? 그렇다면, 내가 내 소명을 찾았다고 생각하나요?
What would make you feel closer to me?	나와 더 가까워지기 위해 무엇을 할 수 있을까요?
Give your partner a compliment you don't think they hear enough.	파트너에게 잘 듣지 못하는 칭찬을 해주세요.
Swap a song suggestion your partner may enjoy. (Both players)	파트너가 좋아할 만한 노래를 추천해 주세요. (양쪽 플레이어)
If you could prescribe me one thing to do for the rest of this month, what would it be and why?	이번 달 나에게 하나를 처방해 준다면, 무엇을 할 것이며 왜 그렇죠?
Take a selfie together.	함께 셀카를 찍어보세요.
What do you think I fear the most?	내가 가장 두려워하는 것은 무엇일까요?
When this game is over, what will you remember about me?	이 게임이 끝나면 나에 대해 무엇을 기억할까요?
When in this game did you feel most connected to me?	이 게임에서 나와 가장 연결된 순간은 언제였나요?
If we were in a band, what would our name be?	우리가 밴드에 있었다면, 우리 밴드 이름은 무엇일까요?
How would you describe me to a stranger?	나를 낯선 사람에게 어떻게 설명할 것인가요?
What do you recommend I let go of, if anything?	내가 놓아줘야 한다고 생각하는 것은 무엇인가요?
Both players share something you're most grateful for in this current moment.	현재 순간에 가장 감사한 것을 나누세요. (양쪽 플레이어)
Write a song about your partner. (30 seconds) Then sing it out loud, get into it! (Both players)	파트너에 대한 노래를 만들어보세요. (30초) 그런 다음 큰 소리로 불러보세요! (양쪽 플레이어)
How does one earn your vulnerability? Have I earned it? How can I earn more?	어떻게 하면 당신의 취약성을 얻을 수 있나요? 내가 그것을 얻었나요? 어떻게 하면 더 얻을 수 있나요?
What can I help you with?	내가 당신을 도울 수 있는 것은 무엇인가요?
What about me most surprised you?	나에 대해 가장 놀랐던 것은 무엇인가요?
In one word, describe how you feel right now.	지금 한 단어로 당신의 기분을 설명해 주세요.
Play a round of rock, paper, scissors. Winner can ask their partner anything. Loser must answer.	가위바위보 한 판 하세요. 이긴 사람은 파트너에게 어떤 질문이든 할 수 있습니다. 진 사람은 대답해야 합니다.
What question were you most afraid to answer?	대답하기 가장 두려웠던 질문은 무엇인가요?
What do you think our most important similarity is?	우리의 가장 중요한 유사점은 무엇이라고 생각하나요?
Based on what you learned about me, does my social media accurately reflect who I am? Why or why not?	내가 알려준 것에 기반하여, 나의 소셜 미디어가 나를 정확하게 반영한다고 생각하나요? 왜 그렇죠? 왜 그렇지 않나요?
What would be the perfect gift for me?	나에게 가장 완벽한 선물은 무엇일까요?
Write down a goal for this year. Fold & exchange. Hold each other accountable. (Both players)	올해의 목표를 적어보세요. 접고 교환하세요. 서로의 목표를 지켜봐 주세요. (양쪽 플레이어)
What has this conversation taught you about yourself?	이 대화가 당신에게 자신에 대해 무엇을 가르쳐 주었나요?
What parts of yourself do you see in me?	당신 자신 중 어떤 부분이 나에게 보이나요?
Dare your partner to do something outside of their comfort zone in the next week. (Both players)	다음 주에 자신의 편안한 영역을 벗어나도록 파트너에게 도전해 보세요. (양쪽 플레이어)
What do I need to hear right now?	지금 당장 들어야 할 것은 무엇인가요?
Give your partner a hug. Not the crappy kind. A warm fluffy one.	파트너에게 따뜻하고 포근한 포옹을 해주세요. 형식적인 포옹 말고요.
Both players write a note to your younger selves. (1 minute) Option to compare.	양쪽 플레이어가 자신의 어린 시절에게 쪽지를 작성해 보세요. (1분) 비교해 볼 수 있습니다.
Give each other nicknames!	서로에게 별명을 지어 주세요!
How do our personalities complement each other?	우리의 성격은 어떻게 서로 보완하나요?
What can we create together?	우리가 함께 무엇을 만들 수 있을까요?
Based on what you know about me, do you have any Netflix recommendations?	나에 대해 아는 것을 바탕으로, 추천할 만한 넷플릭스 작품이 있나요?
What do you admire most about me?	나에게서 가장 존경할 만한 것은 무엇인가요?
What do you think I should know about myself that perhaps I'm unaware of?	아마 내가 모르고 있을 나에 대해 알아야 할 것은 무엇이라고 생각하나요?
Why do you think we met?	우리가 만난 이유는 무엇일까요?
Admit something.	무언가를 고백해 보세요.
What do you think my superpower is?	내 초능력은 무엇이라고 생각하나요?
Based on what you learned about me, what book would you recommend I read?	나에 대해 배운 것에 기반하여, 내가 읽어야 할 책을 추천해 주세요.
Create your own question. Make it count.	자신만의 질문을 만들어보세요. 신중하게 만들어야 합니다.
What do you think my weakness is?	나의 약점은 무엇이라고 생각하나요?
In one word, how would you describe our conversation?	우리 대화를 한 단어로 설명해 주세요.
Write down one thing you want to let go of this year. Read out loud, then rip up together. (Both players)	올해 놓아버리고 싶은 것을 적어보세요. 큰 소리로 읽고, 함께 찢어버리세요. (양쪽 플레이어)
What about me is hardest for you to understand?	나에 대해 가장 이해하기 어려운 점은 무엇인가요?
What do you think my defining characteristic is?	나의 정의적인 특성은 무엇이라고 생각하나요?
Scroll through each other's Instagrams. Find the picture you feel best represents your partner's essence and comment why you chose that image.	서로의 인스타그램을 스크롤하며 상대방의 본질을 가장 잘 나타내는 사진을 찾아 이유를 설명해 주세요.
What answer of mine made you light up?	내 대답 중에서 당신을 밝게 만든 것은 무엇인가요?
What is a lesson you will take away from our conversation?	이 대화에서 가져갈 교훈은 무엇인가요?
What am I most qualified to give advice about?	내가 가장 잘 조언할 수 있는 것은 무엇인가요?
How do you like to celebrate your birthday?	생일을 어떻게 축하하는 것을 좋아하나요?
Are there any foods that you would like to try?	시도해 보고 싶은 음식이 있나요?
If you were travelling round the world, are there any places you avoid?	세계를 여행하는 동안 피하고 싶은 곳이 있나요?
What do you bring with you everywhere you go?	어디를 가든 항상 가지고 다니는 것은 무엇인가요?
What age do you want to live to?	몇 살까지 살고 싶나요?
What is the best aspect of your personality?	당신의 성격 중 가장 좋은 측면은 무엇인가요?
How do you like to celebrate valentines?	발렌타인 데이를 어떻게 축하하는 것을 좋아하나요?
Is it really only the thought that counts?	정말로 생각만으로 충분한가요?
What are some successes you've had in your personal life?	개인 생활에서 어떤 성공을 거두었나요?
What differences would you expect between a four-star and a two-star hotel?	4성급 호텔과 2성급 호텔의 차이점은 무엇일까요?
What holidays have been over commercialized?	과도하게 상업화된 휴일은 무엇인가요?
How far in advance do you like to plan your vacation?	휴가를 얼마나 미리 계획하는 것을 좋아하나요?
What do you get every time you go grocery shopping?	식료품 쇼핑을 할 때마다 항상 사는 것은 무엇인가요?
What was the last concert you went to?	마지막으로 간 콘서트는 무엇이었나요?
How hard should it be to become licensed as a masseuse or a masseur?	마사지사가 되기 위해 자격증을 얻는 것이 얼마나 어려워야 할까요?
Is beauty only in the eye of the beholder, or are some things universally ugly?	아름다움은 보는 사람의 눈에만 있는 것인가요, 아니면 어떤 것은 보편적으로 못생겼나요?
Describe Bacon?	베이컨을 설명해 주세요?
How often do you see your parents?	부모님을 얼마나 자주 보나요?
Do you usually break the rules or follow them?	보통 규칙을 어기나요, 따르나요?
Can our minds correctly interpret reality or is reality subjective?	우리의 마음이 현실을 올바르게 해석할 수 있나요, 아니면 현실은 주관적인가요?
What kind of interior do you like a restaurant to have?	식당 내부를 어떤 스타일로 좋아하나요?
Have you ever dropped anything in the toilet?	변기에 무언가를 떨어뜨린 적이 있나요?
What do you do to get rid of stress?	스트레스를 해소하기 위해 무엇을 하나요?
Have you ever pitched a tent in the dark?	어두운 곳에서 텐트를 쳐본 적이 있나요?
What problems do you want to solve when you grow up?	어른이 되면 어떤 문제를 해결하고 싶나요?
What does your own personal hell look like?	당신만의 지옥은 어떻게 생겼나요?
What is your most embarrassing moment?	가장 창피한 순간은 무엇인가요?
Who in your life brings you the most joy?	당신의 인생에서 가장 큰 기쁨을 가져다주는 사람은 누구인가요?
Who defines good and evil?	선과 악을 누가 정의하나요?
What is the funniest thing that's ever happened to you?	가장 웃긴 일은 무엇인가요?
Would you rather lick someone else's armpit or have someone else likc your armpit?	다른 사람의 겨드랑이를 핥는 것과 다른 사람이 내 겨드랑이를 핥는 것 중 어떤 것을 선택하겠습니까?
Is trust more important than love?	신뢰가 사랑보다 더 중요한가요?
What is your signature dish?	당신의 시그니처 요리는 무엇인가요?
What is freedom?	자유란 무엇인가요?
What is the most beautiful song you have heard?	가장 아름다운 노래는 무엇인가요?
What time of year do you dislike the most?	가장 싫어하는 계절은 언제인가요?
What is the most valuable thing that you own?	가장 가치 있는 소유물은 무엇인가요?
How would you like to die?	어떻게 죽고 싶나요?
What is your favorite TV show?	가장 좋아하는 TV 프로그램은 무엇인가요?
Have you ever gotten a speeding ticket?	과속 딱지를 받은 적이 있나요?
Do you think that the challenges you have faced in your life have made you a better or worse person?	인생에서 겪은 도전들이 당신을 더 나은 사람으로 만들었다고 생각하나요?
What was the last funny video you saw?	마지막으로 본 재미있는 동영상은 무엇인가요?
What are some of your short-term goals?	단기 목표는 무엇인가요?
Have you ever gone on vacation by yourself?	혼자 휴가를 간 적이 있나요?
What book genres do you like to read?	어떤 책 장르를 좋아하나요?
Are you messy or organized?	깔끔한 편인가요, 지저분한 편인가요?
When was the last time you went to a movie theater?	마지막으로 영화관에 간 것은 언제인가요?
What's the most underrated or overrated TV show?	가장 과소평가되거나 과대평가된 TV 프로그램은 무엇인가요?
What is the longest book you have read?	가장 긴 책은 무엇인가요?
What is your biggest success?	가장 큰 성공은 무엇인가요?
Is it better to live where there are four seasons or where one season takes up most of the year?	사계절이 있는 곳에서 사는 것이 좋을까요, 아니면 한 계절이 대부분을 차지하는 곳에서 사는 것이 좋을까요?
What will phones be like in 10 years?	10년 후의 전화기는 어떻게 변할까요?
Who is the most interesting person in your extended family?	당신의 대가족 중 가장 흥미로운 사람은 누구인가요?
What is your favorite season?	가장 좋아하는 계절은 무엇인가요?
If you could invent a holiday, what would it be?	휴일을 발명할 수 있다면, 어떤 휴일을 만들겠습니까?
How important are strong family ties to you?	강한 가족 유대가 얼마나 중요하나요?
What cartoons did you watch as a child?	어린 시절 어떤 만화를 보았나요?
Do you like horror movies?	공포 영화를 좋아하나요?
What is your best skill or talent?	가장 뛰어난 기술이나 재능은 무엇인가요?
What features make a natural area beautiful?	자연 지역을 아름답게 만드는 요소는 무엇인가요?
Which do you prefer, popular music or relatively unknown music?	인기 음악과 상대적으로 알려지지 않은 음악 중 어떤 것을 더 좋아하나요?
What defines you?	당신을 정의하는 것은 무엇인가요?
When do you want to retire?	언제 은퇴하고 싶나요?
What are some of the biggest challenges you have faced?	가장 큰 도전 과제는 무엇인가요?
What do you like to spend your money on?	돈을 어디에 쓰는 것을 좋아하나요?
What things hold you back from doing the things that you really want to?	정말로 하고 싶은 일을 막는 것은 무엇인가요?
How do you plan to make the world a better place?	세상을 더 나은 곳으로 만들 계획이 있나요?
Does your car have a name?	당신의 차에 이름이 있나요?
Would you rather have one wish granted today or three wishes granted five years from now?	오늘 하나의 소원이 이루어지길 원하나요, 아니면 5년 후에 세 개의 소원이 이루어지길 원하나요?
Do you believe in soul mates?	영혼의 반려자를 믿나요?
What was the highlight of your week?	이번 주의 하이라이트는 무엇이었나요?
Are some lives more valuable than others?	모든 생명이 동일한 가치를 가지고 있다고 생각하나요?
What was your first smartphone?	당신의 첫 스마트폰은 무엇이었나요?
How have TV shows changed over the years?	TV 프로그램이 어떻게 변해왔나요?
What three websites do you visit daily?	매일 방문하는 웹사이트 세 곳은 어디인가요?
Parking is a problem in many cities. How could parking in your city be improved?	많은 도시에서 주차 문제가 있습니다. 당신의 도시에서 주차를 어떻게 개선할 수 있을까요?
If you were a king/queen, what would your throne look like?	당신이 왕/여왕이라면, 당신의 왕좌는 어떻게 생겼을까요?
Do you think that a being a masseur or a masseuse is a respected profession?	마사지사가 존경받는 직업이라고 생각하나요?
Do you sleep with a stuffed animal?	봉제인형과 함께 자나요?
How accountable should journalists be to making sure the news they are reporting is accurate?	언론인들이 보도하는 뉴스의 정확성을 얼마나 책임져야 한다고 생각하나요?
What do you hope to achieve in your professional life?	전문적으로 이루고 싶은 것은 무엇인가요?
Is it ever ok to cheat?	부정행위는 괜찮은가요?
What would be your perfect weekend?	완벽한 주말은 무엇인가요?
Who is someone who is popular now that you really like?	지금 인기가 많은 사람 중 정말로 좋아하는 사람은 누구인가요?
What is the most useful app on your phone?	휴대폰에서 가장 유용한 앱은 무엇인가요?
What's your favorite comfort food?	가장 좋아하는 위로 음식은 무엇인가요?
What is your favorite candy?	가장 좋아하는 사탕은 무엇인가요?
Are you a good friend?	좋은 친구인가요?
Would you rather be a master of every musical instrument or be fluent in every language?	모든 악기를 마스터할 수 있다면, 아니면 모든 언어를 유창하게 할 수 있다면 어떤 것을 선택하겠습니까?
What's the funniest TV series you have seen?	가장 웃긴 TV 시리즈는 무엇인가요?
What is the hardest sport to excel at?	가장 어려운 스포츠는 무엇인가요?
Do you wish you were shorter?	더 키가 작았으면 좋겠나요?
Would you rather your flight be delayed by 8 hours or lose your luggage?	비행이 8시간 지연되는 것과 짐을 잃어버리는 것 중 무엇을 선택하겠습니까?
If you knew you couldn't fail, what would you do?	실패할 수 없다는 것을 알면 무엇을 하겠습니까?
What is something that really annoys you but doesn't bother most people?	다른 사람은 신경 쓰지 않지만 정말 짜증나는 것은 무엇인가요?
If money cannot buy happiness, can you ever be truly happy with no money?	돈으로 행복을 살 수 없다면, 돈 없이도 진정으로 행복할 수 있을까요?
If your life was a meal, what kind of meal would it be?	당신의 삶이 하나의 식사라면, 어떤 식사일까요?
What do you think of tour group packages?	여행 그룹 패키지에 대해 어떻게 생각하나요?
Would you rather have no sense of smell or smell everything near you as though it were right in front of your nose?	냄새를 맡을 수 없게 되는 것과 주변의 모든 것을 코앞에서 맡는 것처럼 맡는 것 중 무엇을 선택하겠습니까?
What is the best piece of advice you've received?	받은 최고의 조언은 무엇인가요?
What was the most over hyped place you've traveled to?	과대평가된 여행지는 어디였나요?
What piece of technology is really frustrating to use?	사용하기 정말 어려운 기술은 무엇인가요?
Does fashion help society in any way?	패션이 사회에 어떤 도움을 줄까요?
Where is the most beautiful place you have been?	가장 아름다운 곳은 어디였나요?
What is a challenge you would never want to face?	절대 직면하고 싶지 않은 도전 과제는 무엇인가요?
After a long day, do you prefer to hang out with friends or spend time alone?	긴 하루를 보낸 후 친구들과 어울리는 것을 더 좋아하나요, 아니면 혼자 시간을 보내는 것을 더 좋아하나요?
Who in your family gives good gifts?	가족 중 선물을 잘 주는 사람은 누구인가요?
What are some goals you have already achieved?	이미 달성한 목표는 무엇인가요?
Do you prefer physical books or eBooks?	종이책과 전자책 중 어떤 것을 더 선호하나요?
What is your favorite shirt?	가장 좋아하는 셔츠는 무엇인가요?
What is something that you have gotten in trouble for at school/work?	학교나 직장에서 문제를 일으킨 적이 있나요?
What do you think happens after death?	죽음 후에 무엇이 일어난다고 생각하나요?
What is a miracle that happens every day?	매일 일어나는 기적은 무엇인가요?
How does journalism serve society? Is it doing a good job?	언론이 사회에 어떤 역할을 하나요? 잘 하고 있나요?
Do you prefer traveling alone or with a group?	혼자 여행하는 것을 좋아하나요, 아니면 그룹과 함께 여행하는 것을 좋아하나요?
Is being a journalist a respectable job?	언론인이라는 직업이 존경받을 만한 직업이라고 생각하나요?
Do you prefer to travel or stay close to home?	여행을 좋아하나요, 아니면 집에 가까이 있는 것을 선호하나요?
Should people care more about doing the right things, or doing things right?	옳은 일을 하는 것과 일을 제대로 하는 것 중 무엇이 더 중요하다고 생각하나요?
Do you prefer cats or dogs?	고양이와 개 중 어떤 것을 더 좋아하나요?
What is your opinion of hitch-hiking?	히치하이킹에 대해 어떻게 생각하나요?
Do you enjoy shopping for gifts?	선물 쇼핑을 좋아하나요?
What smell brings back great memories?	좋은 기억을 떠올리게 하는 냄새는 무엇인가요?
How has the education you received changed your life?	받은 교육이 당신의 삶을 어떻게 바꾸었나요?
What do you think of online education?	온라인 교육에 대해 어떻게 생각하나요?
What is the difference between friends and acquaintances?	친구와 지인의 차이점은 무엇인가요?
How would your friends and family describe you?	친구와 가족이 당신을 어떻게 묘사할까요?
How do you feel if you accidentally leave your phone at home?	휴대폰을 집에 두고 나가면 어떤 기분이 드나요?
What are some strange beliefs that you have?	이상한 믿음이 있나요?
Do you like spicy food?	매운 음식을 좋아하나요?
What is the longest plane trip you have taken?	가장 긴 비행은 무엇이었나요?
What is the most challenging job you can think of?	가장 도전적인 직업은 무엇인가요?
What was the last book you read?	마지막으로 읽은 책은 무엇인가요?
What do you think buffets?	뷔페에 대해 어떻게 생각하나요?
Have you ever been rock climbing?	암벽 등반을 해본 적이 있나요?
Do you always have the latest phone?	항상 최신 휴대폰을 가지고 있나요?
If you win the lottery would you still be working or going to school?	복권에 당첨되면 계속 일하거나 학교에 다닐 건가요?
If you had three wishes, what would they be?	세 가지 소원을 이룰 수 있다면, 무엇을 원하겠습니까?
Have you ever been to any large family reunions? How was it?	큰 가족 모임에 참석한 적이 있나요? 어땠나요?
What's the hardest thing about being a girl?	여자로서 가장 힘든 것은 무엇인가요?
What is something you have never done but would like to do?	한 번도 해본 적 없지만 해보고 싶은 것은 무엇인가요?
What is the most annoying habit someone can have?	가장 짜증나는 습관은 무엇인가요?
What's the hardest thing about being a boy?	남자로서 가장 힘든 것은 무엇인가요?
How often do you clean your home?	집을 얼마나 자주 청소하나요?
What book has had the biggest impact on your life?	당신의 삶에 가장 큰 영향을 미친 책은 무엇인가요?
Do you consider environment issues when you plan and take a vacation?	휴가를 계획할 때 환경 문제를 고려하나요?
What was the last time you worked incredibly hard?	마지막으로 정말 열심히 일한 것은 언제인가요?
What's the longest you've gone without showering?	샤워를 하지 않고 가장 오래 버틴 시간은 얼마인가요?
How often do you use your phone?	휴대폰을 얼마나 자주 사용하나요?
How can journalism be improved?	언론이 어떻게 개선될 수 있을까요?
Where and when was the most amazing sunset you have ever seen?	가장 놀라운 일몰을 본 곳과 시간은 언제인가요?
What method of transport do you use most often?	가장 자주 사용하는 교통수단은 무엇인가요?
What is truth?	진실이란 무엇인가요?
If you could have any super power, what would it be?	어떤 초능력을 가지고 싶나요?
Can people with vastly different cultural backgrounds live together peacefully?	매우 다른 문화적 배경을 가진 사람들이 평화롭게 함께 살 수 있을까요?
Do you prefer vacation which include a lot of activities or more relaxing ones?	많은 활동이 포함된 휴가를 좋아하나요, 아니면 더 편안한 휴가를 좋아하나요?
Where would your ideal holiday destination be?	이상적인 휴가지가 어디인가요?
Would you like to go on a long cruise?	긴 크루즈 여행을 가고 싶나요?
Which do you prefer, books or movies?	책과 영화 중 어떤 것을 더 좋아하나요?
When your holiday is finished are you glad to get back to work (or school) or do you dread it?	휴가가 끝나면 일(또는 학교)로 돌아가는 것이 기쁜가요, 아니면 두려운가요?
Did you do anything special this past weekend?	지난 주말에 특별한 일을 했나요?
Were you the class clown or teacher's pet?	반에서 가장 웃긴 아이였나요, 아니면 선생님의 애완동물이었나요?
Has anyone ever saved your life?	누군가가 당신의 생명을 구한 적이 있나요?
Where did you grow up?	어디에서 자랐나요?
What do you do during recess?	쉬는 시간에 무엇을 했나요?
What piece of technology would look like magic or a miracle to people in medieval Europe?	어떤 기술이 중세 유럽 사람들에게 기적이나 마법처럼 보일까요?
Would you rather drink a cup of spoiled milk or pee your pants in public?	상한 우유를 마시는 것과 공공장소에서 바지를 적시는 것 중 무엇을 선택하겠습니까?
What technology from a science fiction movie would you most likely to have?	SF 영화에서 어떤 기술을 가장 가지고 싶나요?
What's the strangest movie you have ever seen?	가장 이상한 영화는 무엇이었나요?
If you could call up anyone in the world and have a one hour conversation, who would you call?	세계에서 누구에게나 전화를 걸어 한 시간 동안 대화할 수 있다면 누구에게 전화를 걸겠습니까?
If you had to give up one of your five senses, which one would it be and why?	다섯 가지 감각 중 하나를 포기해야 한다면, 어떤 것을 선택하겠습니까? 왜 그렇죠?
How would you change the world if you could?	세계를 어떻게 바꾸고 싶나요?
What do you think the next big technological advance will be?	다음 큰 기술 발전은 무엇이 될 것 같나요?
Which of your personality traits has been the most useful?	당신의 성격 중 가장 유용한 특징은 무엇인가요?
Do you prefer to wear fashionable clothes or comfortable clothes?	유행하는 옷을 입는 것과 편안한 옷을 입는 것 중 어떤 것을 더 좋아하나요?
What was the best birthday gift you ever had?	가장 좋은 생일 선물은 무엇이었나요?
Do you untie your shoes before taking them off?	신발을 벗을 때 끈을 풀나요?
What is the most recent success you've had?	가장 최근에 성공한 일은 무엇인가요?
Would you rather only be able to whisper or only be able to shout everything?	항상 속삭이기만 하거나 항상 소리쳐야 한다면, 어떤 것을 선택하겠습니까?
Do you believe in fate?	운명을 믿나요?
What do app makers do that really annoys you?	앱 개발자들이 정말 짜증나게 하는 것은 무엇인가요?
Do you think that challenges improve a person's character?	도전이 사람의 성격을 향상시키나요?
Do you prefer to watch movies in the theater or at home?	영화를 극장에서 보는 것과 집에서 보는 것 중 어떤 것을 더 선호하나요?
What is the last thing that you think of before you go to sleep?	잠들기 전에 마지막으로 생각하는 것은 무엇인가요?
What is the purpose of art in society?	예술이 사회에 어떤 역할을 하나요?
What is your favorite toy?	가장 좋아하는 장난감은 무엇인가요?
What is something you've but would never do again?	한 번 해본 것이지만 다시는 하고 싶지 않은 것은 무엇인가요?
What is the most beautiful thing in your life?	삶에서 가장 아름다운 것은 무엇인가요?
Which TV show do you want your life to be like?	당신의 인생이 닮고 싶은 TV 프로그램은 무엇인가요?
Do you make your own decisions, or let others make them for you?	스스로 결정을 내리나요, 아니면 다른 사람들이 대신 결정을 내리도록 하나요?
Would you rather be a genius in a world of morons, or a moron in a world of geniuses?	멍청이들 사이의 천재로 사는 것과 천재들 사이의 멍청이로 사는 것 중 어떤 것을 선택하겠습니까?
What is a fashion trend you are really glad went away?	정말 기뻤던 패션 트렌드는 무엇인가요?
What song always puts you in a good mood?	항상 기분 좋게 해주는 노래는 무엇인가요?
What is the latest you've stayed up this past week?	지난 주에 가장 늦게까지 깨어있었던 시간은 언제인가요?
What is the best room in your house?	집에서 가장 좋은 방은 어디인가요?
Describe your dream house.	꿈의 집을 설명해 주세요.
What do you think is the meaning of life?	삶의 의미는 무엇인가요?
What was the worst job that you've ever had?	가장 끔찍한 직업은 무엇이었나요?
When going on a vacation, would you prefer to join a tour or plan out everything by yourself?	휴가를 갈 때 투어에 참여하는 것과 모든 것을 직접 계획하는 것 중 어떤 것을 선호하나요?
What was your favorite book as a child?	어린 시절 가장 좋아했던 책은 무엇인가요?
What is the craziest diet you've heard of?	가장 미친 다이어트는 무엇이었나요?
What type of kid were you? Shy, trouble maker, quiet?	어떤 아이였나요? 수줍음이 많았나요, 문제를 일으키는 아이였나요, 조용했나요?
What will the future of education be?	교육의 미래는 어떻게 될까요?
Do people have an obligation to help others?	사람들이 다른 사람들을 도와야 할 의무가 있나요?
What is your favorite children's book?	가장 좋아하는 어린이 책은 무엇인가요?
What food looks disgusting but tastes delicious?	보기에는 끔찍하지만 맛은 훌륭한 음식은 무엇인가요?
What personality traits in other people do you hate?	다른 사람들의 성격 중 어떤 점을 싫어하나요?
Did you help anyone today?	오늘 누군가를 도왔나요?
How many parking tickets have you received?	주차 티켓을 몇 번 받았나요?
What do you do to improve your mood when you are in a bad mood?	기분이 나쁠 때 기분을 개선하기 위해 무엇을 하나요?
A portal to another world opens in front of you. Do you go through?	당신 앞에 다른 세계로 가는 포털이 열립니다. 들어가시겠습니까?
Are you a leader or a follower?	리더인가요, 팔로워인가요?
What do you use to listen to music?	음악을 듣기 위해 무엇을 사용하나요?
What is the worst injury you've had?	가장 심한 부상은 무엇이었나요?
What is the silliest fear you have?	가장 어리석은 두려움은 무엇인가요?
Who in your family are you most like?	가족 중 당신과 가장 닮은 사람은 누구인가요?
What's the worst movie you have seen recently?	최근에 본 최악의 영화는 무엇인가요?
What do you think of standardized tests?	표준화된 시험에 대해 어떻게 생각하나요?
Who was your best friend in elementary school?	초등학교 때 가장 친한 친구는 누구였나요?
What is your favorite meal of the day?	하루 중 가장 좋아하는 식사는 무엇인가요?
What are your plans for this weekend?	이번 주말에 어떤 계획이 있나요?
Would you rather go forward or back in time?	미래로 가는 것과 과거로 가는 것 중 무엇을 선택하겠습니까?
When was the last time you got a professional or amateur massage?	마지막으로 전문 마사지나 아마추어 마사지를 받은 것은 언제인가요?
Do you think getting massages will become more or less popular as time goes by?	시간이 지나면서 마사지는 더 인기를 끌까요, 아니면 덜 인기를 끌까요?
Who is your favorite music artist?	가장 좋아하는 음악가는 누구인가요?
Who are some of your favorite athletes?	가장 좋아하는 운동 선수는 누구인가요?
What defines a sport? Is fishing a sport? How about video game tournaments?	스포츠를 정의하는 것은 무엇인가요? 낚시는 스포츠인가요? 비디오 게임 대회는 어떤가요?
What is your opinion of horse riding?	승마에 대해 어떻게 생각하나요?
What's an ideal Christmas for you?	이상적인 크리스마스는 무엇인가요?
Do you prefer gentle relaxing massages or a strong massage?	부드럽고 편안한 마사지와 강한 마사지 중 어떤 것을 선호하나요?
What is your evening routine like?	저녁 일과는 어떻게 되나요?
What's the most addictive mobile game you have played?	가장 중독성 있는 모바일 게임은 무엇이었나요?
If you knew that you only had a year left to live, what would you do?	1년 남았다는 사실을 알게 된다면 무엇을 하겠습니까?
Are you a heavy or a light sleeper?	잠을 많이 자나요, 아니면 적게 자나요?
How much do you plan for the future?	미래를 얼마나 계획하나요?
Who is your oldest friend? Where did you meet them?	가장 오래된 친구는 누구인가요? 어디에서 만났나요?
What is your favorite pizza topping?	가장 좋아하는 피자 토핑은 무엇인가요?
How can governments make education more efficient?	정부가 교육을 더 효율적으로 만들기 위해 무엇을 할 수 있을까요?
What one piece of advice would you offer to a newborn child?	신생아에게 줄 한 가지 조언은 무엇인가요?
Would you rather be 10 minutes late or be 20 minutes early for everything?	항상 10분 늦게 도착하는 것과 항상 20분 일찍 도착하는 것 중 어떤 것을 선택하겠습니까?
How often do you stay up past 3 a.m.?	새벽 3시 이후에 얼마나 자주 깨어 있나요?
What is the best pair of shoes you have ever owned?	가장 좋아하는 신발은 무엇인가요?
Will technology save the human race or destroy it?	기술이 인류를 구할까요, 아니면 파괴할까요?
Do you shower in the morning or at night? Why?	아침에 샤워하나요, 아니면 밤에 샤워하나요? 왜 그렇죠?
What is your favorite clothing brand?	가장 좋아하는 의류 브랜드는 무엇인가요?
An app mysteriously appears on your phone that does something amazing. What does it do?	놀라운 일을 하는 앱이 휴대폰에 갑자기 나타났다면, 무엇을 할까요?
What movie scene choked you up the most?	가장 감동적인 영화 장면은 무엇인가요?
What is your favorite ice cream flavor?	가장 좋아하는 아이스크림 맛은 무엇인가요?
Which is more important, a great car or a great house?	좋은 차와 좋은 집 중 무엇이 더 중요한가요?
What is your favorite movie?	가장 좋아하는 영화는 무엇인가요?
Would you rather go through life unable to answer any questions or unable to ask any questions?	질문에 답할 수 없게 사는 것과 질문을 할 수 없게 사는 것 중 무엇을 선택하겠습니까?
What was your worst restaurant experience?	가장 끔찍한 식당 경험은 무엇이었나요?
Have you ever had an accident while travelling?	여행 중 사고를 당한 적이 있나요?
What are the best and worst parts of human nature?	인간 본성의 가장 좋은 부분과 나쁜 부분은 무엇인가요?
Have you ever turned a failure into a win?	실패를 승리로 바꾼 적이 있나요?
If you became president, what is the first thing you would do?	대통령이 되면 가장 먼저 무엇을 하겠습니까?
What does honor mean to you?	명예란 무엇인가요?
What makes a piece of art beautiful to you?	예술 작품을 아름답게 만드는 것은 무엇인가요?
When you are in another country, do you usually buy a phrase book to attempt to speak the local language?	다른 나라에 있을 때 보통 문구책을 사서 현지 언어를 시도해 보나요?
Which sport is the most exciting to watch?	가장 흥미진진한 스포츠는 무엇인가요?
What are you afraid of?	무서운 것은 무엇인가요?
What are some good and bad things about the education system in your country?	당신 나라의 교육 시스템에 대해 좋은 점과 나쁜 점은 무엇인가요?
What is the most embarrassing piece of clothing you own?	가장 창피한 옷은 무엇인가요?
What does your own personal hell look like?	당신만의 지옥은 어떻게 생겼나요?
What is the strangest app you have heard or tried?	가장 이상한 앱은 무엇이었나요?
Where would you like to travel next?	다음에 여행하고 싶은 곳은 어디인가요?
What annoys you most when you are driving?	운전할 때 가장 짜증나는 것은 무엇인가요?
What do you like to do to relax?	긴장을 풀기 위해 무엇을 하나요?
Have you tried any different types of massages other than the traditional kind?	전통적인 마사지 외에 다른 종류의 마사지를 시도해 본 적이 있나요?
What is a year of life worth?	인생의 가치는 얼마인가요?
How much of personality is genetic and how much is from the environment?	성격은 얼마나 유전적이고 얼마나 환경적일까요?
Do you have a bicycle?	자전거가 있나요?
What was the best time period of your life? What do you think will be the best time period of your entire life?	당신의 인생에서 가장 좋은 시기는 언제였나요? 앞으로 가장 좋은 시기는 언제일 것 같나요?
How good are you at starting a campfire?	캠프파이어를 시작하는 데 얼마나 능숙한가요?
Is gift giving common among all cultures?	선물 주기는 모든 문화에서 공통적인가요?
What's your favorite non-alcoholic drink?	가장 좋아하는 무알코올 음료는 무엇인가요?
What are some of your long-term goals?	장기 목표는 무엇인가요?
Do you believe people are inherently good?	사람들이 본질적으로 선하다고 믿나요?
Best Halloween costume you ever had?	가장 기억에 남는 할로윈 의상은 무엇인가요?
Would you rather be rich and never find true love or be poor and find true love?	부자가 되고 진정한 사랑을 찾지 못하는 것과 가난하고 진정한 사랑을 찾는 것 중 무엇을 선택하겠습니까?
Which season are you most active in?	가장 활동적인 계절은 언제인가요?
Time freezes for everyone but you for one day. What do you do?	시간이 멈추고 당신만 하루 동안 움직일 수 있다면 무엇을 하겠습니까?
Do you usually try to bring back interesting souvenirs from your holidays?	휴가에서 흥미로운 기념품을 가져오려고 노력하나요?
If you could choose just one thing to change about the world, what would it be?	세상에서 한 가지를 바꿀 수 있다면 무엇을 바꾸겠습니까?
Does it matter how a gift is wrapped or is it only the gift that matters?	선물 포장이 중요합니까, 아니면 선물만 중요합니까?
What trends did you follow when you were younger?	젊었을 때 어떤 트렌드를 따랐나요?
How much control do you have over your life?	삶을 얼마나 통제할 수 있나요?
What old trend is coming back these days?	요즘 다시 유행하는 오래된 트렌드는 무엇인가요?
In an ideal world, what would the next year in your life look like?	이상적인 세상에서 다음 해 당신의 삶은 어떻게 될까요?
What are two things you love about where you live right now?	지금 살고 있는 곳에서 사랑하는 두 가지는 무엇인가요?
Has anything ever happened to you that you could not, and still cannot, explain?	설명할 수 없고 아직도 설명할 수 없는 일이 있었나요?
If you had to spend a year abroad, where would you go?	해외에서 1년을 보내야 한다면 어디로 가겠습니까?
Do you feel most connected to the past, present, or future?	과거, 현재, 미래 중 어느 쪽에 가장 연결되어 있다고 느끼나요?
What message would you put on a billboard for thousands of people to see every day?	매일 수천 명이 볼 수 있는 광고판에 어떤 메시지를 넣고 싶나요?
If you have or were to have children, what is one lesson you would like to share with them?	자녀가 있거나 자녀를 가질 계획이라면, 그들에게 전하고 싶은 교훈은 무엇인가요?
If you were to go back in time 10 years and tell yourself one thing, what would it be?	10년 전으로 돌아가 자신에게 한 가지를 말할 수 있다면 무엇을 말하겠습니까?
How have you changed this past year?	지난해 당신은 어떻게 변했나요?
What has been your favorite age so far? Why?	지금까지 가장 좋아하는 나이는 몇 살이었나요? 왜 그렇죠?
How have you spiritual views changed in the last decade?	지난 10년 동안 영적 견해가 어떻게 변했나요?
When was the last time you felt truly appreciated?	마지막으로 진정으로 감사함을 느꼈던 때는 언제였나요?
Has there ever been a time in your life when you felt you could never fully repay someone? When was it?	누군가에게 절대 갚을 수 없다고 느꼈던 순간이 있었나요? 언제였나요?
Who in your life are you most grateful for?	당신 인생에서 가장 감사한 사람은 누구인가요?
Was there ever a moment when your life changed course because of an action you took? What was it?	자신의 행동으로 인해 인생의 방향이 바뀐 순간이 있었나요? 무엇이었나요?
What is more important to you: justice or forgiveness?	정의와 용서 중 무엇이 더 중요합니까?
When is it okay to not be completely honest?	완전히 정직하지 않아도 되는 때는 언제인가요?
If you were to die today, what would you most regret not having told someone? Why haven't you told them yet?	오늘 죽는다면 누군가에게 가장 후회할 일이 무엇일까요? 왜 아직 말하지 않았나요?
What, if anything, is too serious to be joked about?	농담으로는 절대 할 수 없는 일은 무엇인가요?
Do you have any regrets?	후회한 적이 있나요?
What is the greatest act of bravery you have witnessed?	목격한 가장 용감한 행동은 무엇인가요?
What irrational fears do you have now?	지금 가지고 있는 비이성적인 두려움은 무엇인가요?
What mistake have you learned the most from?	가장 많이 배운 실수는 무엇인가요?
What is your kryptonite (or greatest weakness)?	당신의 약점(혹은 가장 큰 약점)은 무엇인가요?
What social issues fire you up?	어떤 사회적 문제가 당신을 가장 화나게 하나요?
What are two things still on your bucket list?	버킷리스트에 아직 남아 있는 두 가지는 무엇인가요?
Is there something that you've dreamed of doing for a long time? Why haven't you done it?	오랫동안 꿈꾸어 왔지만 아직 하지 않은 일은 무엇인가요?
If you could pick any career path and you were guaranteed to be successful, what would you choose?	성공이 보장된다면 어떤 경로를 선택하겠습니까?
What have you read, seen, or listened to that has shaped your life?	당신의 인생을 형성한 것은 무엇을 읽고, 보고, 듣고 했나요?
If you weren't self-conscious or worried about failing, what form of expression would you explore?	자기 인식이나 실패에 대한 걱정 없이 어떤 형태의 표현을 탐구하고 싶나요?
What character from a book, movie, or TV show is most similar to you?	당신과 가장 닮은 책, 영화, TV 프로그램의 캐릭터는 누구인가요?
What is something creative you did when you were younger that you no longer do? What don't you do it anymore?	어릴 때 했던 창의적인 활동은 무엇인가요? 왜 더 이상 하지 않나요?
What is the closest you have ever come to dying?	죽을 뻔했던 순간은 언제인가요?
What is one fear you would like to conquer?	극복하고 싶은 두려움은 무엇인가요?
When was the last time you tried something totally new?	마지막으로 완전히 새로운 것을 시도한 것은 언제인가요?
What is the biggest risk you've taken? If you had another chance, would you do anything differently?	가장 큰 위험을 감수했던 순간은 언제인가요? 다시 기회가 주어진다면 다르게 할 것인가요?
Your house and everything you own catches fire. All pets and people are safe, but you can save one item. What would you choose?	집이 불타고 모든 것을 잃었다고 가정합시다. 모든 사람과 애완동물은 안전하지만 하나의 아이템만 구할 수 있습니다. 무엇을 선택하겠습니까?
If there is an afterlife or reincarnation, what one memory from this life would you bring with you?	내세나 환생이 있다면, 이 삶의 어떤 기억을 가지고 가고 싶나요?
What are you holding on to that you need to let go of?	놓아버려야 할 것은 무엇인가요?
How often do you feel guilty and how do you deal with it?	얼마나 자주 죄책감을 느끼며, 어떻게 대처하나요?
What's one thing that really helps you when you're feeling down?	기분이 나쁠 때 정말 도움이 되는 것은 무엇인가요?
What makes you weird?	당신을 이상하게 만드는 것은 무엇인가요?
What's one thing you could do to take better care of yourself?	자신을 더 잘 돌보기 위해 할 수 있는 일은 무엇인가요?
What are you doing right now that your future self will thank you for?	미래의 자신이 지금 하고 있는 일에 감사할 것이라고 생각하나요?
When was the last time you forgave a friend?	마지막으로 친구를 용서한 것은 언제인가요?
Is it better to let relationships ebb and flow in and out of our lives or intentionally try and maintain them?	관계를 자연스럽게 흘러가게 하는 것이 좋나요, 아니면 의도적으로 유지하는 것이 좋나요?
What family tradition did you think was weird as a kid but you now appreciate?	어렸을 때 이상하게 생각했지만 이제는 감사하게 여기는 가족 전통은 무엇인가요?
If you could change anything about your childhood, what would it be?	어린 시절을 바꿀 수 있다면, 무엇을 바꾸겠습니까?
How did you (or will you) know you are in love?	어떻게 사랑에 빠졌는지 알 수 있었나요?
How do you want to be remembered?	어떻게 기억되고 싶나요?
What are your worst habits?	가장 나쁜 습관은 무엇인가요?
If you knew that you would die in five years, what would you change about the way you live now? Why?	5년 후에 죽는다는 것을 알았다면, 지금의 삶에서 무엇을 바꾸겠습니까? 왜 그렇죠?
If a crystal ball could tell you the truth about your life, the world, or anything else, what would you want to know?	수정 구슬이 당신의 인생, 세계 또는 다른 것에 대한 진실을 알려줄 수 있다면, 무엇을 알고 싶나요?
What is one thing you do that sets you up for a great day?	훌륭한 하루를 보내기 위해 어떤 일을 하나요?
What does your "perfect" day look like?	당신의 "완벽한" 하루는 어떻게 생겼나요?
WHat are your best habits?	가장 좋은 습관은 무엇인가요?
Do you make decisions more with your head or heart?	머리로 결정하나요, 마음으로 결정하나요?
Who was your first true friend and what brought you together?	첫 번째 진정한 친구는 누구였고, 무엇이 그들을 함께하게 만들었나요?
Describe a time you thought your parents were 100% wrong but eventually learned they were kind of right.	부모님이 100% 틀렸다고 생각했지만 결국에는 어느 정도 옳다는 것을 깨달았던 순간을 설명해 보세요.
What is one meal your parents or grandparents made that you wish you knew how to make?	부모님이나 조부모님이 만들었던 한 끼 식사를 배우고 싶나요?
Who have you lost touch with but still wonder about?	연락이 끊겼지만 여전히 궁금한 사람은 누구인가요?
Would you describe yourself as an extrovert or an introvert? Why?	외향적인가요, 내향적인가요? 왜 그렇죠?
Do you have any rituals or home remedies for feeling better when you get sick?	아플 때 기분을 나아지게 하기 위해 사용하는 의식이나 민간요법이 있나요?
If you lived to the age of 90, would you rather retain the mind or body of a 30-year-old for the last 60 years of your life?	90세까지 산다면, 마지막 60년 동안 30세의 정신이나 신체를 유지하고 싶나요?
Are all emotions beautiful?	모든 감정이 아름다운가요?
What is the kindest thing a stranger has ever done for you?	낯선 사람이 해준 가장 친절한 일은 무엇인가요?
How difficult is it for you to forgive someone who refuses to apologize?	사과를 거부하는 사람을 용서하는 것이 얼마나 어렵나요?
What is one thing that doesn't cost anything, occurs naturally, and always makes you smile?	돈이 들지 않고 자연스럽게 일어나는 것 중 항상 미소를 짓게 하는 것은 무엇인가요?
What is something you wanted for a long time, but once you acquired it, it didn't quite meet your expectation?	오랫동안 원했지만 얻었을 때 기대에 미치지 못한 것은 무엇인가요?
What types of things have you collected in the past?	과거에 어떤 것을 수집했나요?
If you could spend a day as any animal, which would you choose?	하루 동안 동물로 변할 수 있다면, 어떤 동물을 선택하겠습니까?
Which feels worse: failing or not trying?	실패와 시도하지 않음 중 어느 것이 더 나쁜가요?
When you think about adventures in your childhood, what memory comes to mind?	어린 시절의 모험을 떠올리면 어떤 기억이 떠오르나요?
Describe the worst place you've ever tried to sleep.	가장 끔찍한 잠자리 경험은 무엇이었나요?
What movies have you watched more than three times?	세 번 이상 본 영화는 무엇인가요?
If you could have front row seats to any concert, ever, what would you choose?	어떤 콘서트의 맨 앞자리에 앉을 수 있다면, 어떤 콘서트를 선택하겠습니까?
If you could be a world-class talent on any instrument, which would it be?	세계적인 수준의 재능을 가질 수 있다면, 어떤 악기를 선택하겠습니까?
What's one book you recommend and why?	추천하고 싶은 책은 무엇인가요? 이유는 무엇인가요?
What in your life are you most excited about right now?	현재 가장 흥분되는 일은 무엇인가요?
When you were a kid, what did you want to be when you grew up?	어린 시절에 꿈꾸던 직업은 무엇이었나요?
If you didn't have to sleep, what would you do with the extra time?	잠을 자지 않아도 된다면, 여분의 시간을 무엇에 사용하겠습니까?
When do you feel most alive?	언제 가장 살아있다고 느끼나요?
What's your superpower?	당신의 초능력은 무엇인가요?
What is the most challenging thing you're dealing with right now?	현재 가장 어려운 문제는 무엇인가요?
What is your proudest accomplishment?	가장 자랑스러운 업적은 무엇인가요?
What irrational fears did you have as a child?	어린 시절에 가졌던 비이성적인 두려움은 무엇인가요?
Who is the most resilient person you know? What makes them resilient?	당신이 아는 가장 회복력이 강한 사람은 누구인가요? 무엇이 그들을 회복력 있게 만들었나요?
If you could wake up tomorrow having gained any one quality, what would it be?	내일 아침 일어났을 때 어떤 자질을 갖추고 싶나요?
What are three words the people closest in your life would use to describe you?	가까운 사람들은 당신을 어떻게 묘사할까요? 세 가지 단어로 표현해 보세요.
What's the best piece of advice you've ever been given?	받은 최고의 조언은 무엇인가요?
Do intentions matter more or less than actions?	의도는 행동보다 중요합니까, 덜 중요합니까?
Do you identify as a spiritual person? If so, in why way?	영적이라고 생각하나요? 그렇다면 어떤 방식으로요?
Describe a time you got into big trouble when you were younger.	어렸을 때 큰 문제에 빠졌던 경험을 설명해 보세요.
What are you grateful for right now?	지금 무엇에 감사하나요?
Where do you find peace?	어디에서 평화를 찾나요?
What do you normally take for granted?	보통 당연하게 여기는 것은 무엇인가요?
What is one magical memory from this past year?	지난해 가장 마법 같은 기억은 무엇인가요?
What is one thing that is unique about the place you grew up?	자란 곳에서 독특한 점은 무엇인가요?
What is a memory that will forever make you laugh out loud?	평생 웃음을 터뜨릴 기억은 무엇인가요?
What is your most memorable childhood accident?	가장 기억에 남는 어린 시절 사고는 무엇인가요?
Who was your most memorable teacher?	가장 기억에 남는 선생님은 누구인가요?
If you could gift all humans one thing, what would it be?	모든 인간에게 하나의 선물을 준다면, 무엇을 선택하겠습니까?
Are you superstitious about anything?	무엇에 대해 미신을 믿나요?
Who in this group is the most likely to yell at the ref in a little league game?	이 그룹에서 리틀 리그 경기에서 심판에게 가장 소리를 지를 것 같은 사람은 누구인가요?
Who in this group is most likely to make it through a zombie apocalypse?	이 그룹에서 좀비 아포칼립스를 가장 잘 살아남을 것 같은 사람은 누구인가요?
Who in this group is the most likely to own an illegal business?	이 그룹에서 불법 사업을 운영할 가능성이 가장 높은 사람은 누구인가요?
Who in this group is most likely to die first in a horror movie?	이 그룹에서 공포 영화에서 가장 먼저 죽을 가능성이 가장 높은 사람은 누구인가요?
What's something that everyone in this group can agree on?	이 그룹에서 모두가 동의할 수 있는 것은 무엇인가요?
What was the worst date you've been on?	가장 끔찍한 데이트는 무엇이었나요?
What is your greatest fear?	가장 큰 두려움은 무엇인가요?
If the person next to you were convicted of a crime, what would it be for?	옆에 있는 사람이 범죄로 유죄 판결을 받았다면, 무엇 때문일까요?
What assumption did you make that turned out to be completely wrong?	완전히 잘못된 가정을 한 적이 있나요?
What is the scariest movie you've ever seen?	가장 무서운 영화는 무엇이었나요?
If you were featured on the local news, what would it most likely be for?	지역 뉴스에 나온다면, 어떤 이유일까요?
What do you wish were illegal?	불법이기를 바라는 것은 무엇인가요?
Who understands you better than anyone else?	당신을 가장 잘 이해하는 사람은 누구인가요?
If you had to pick someone else to choose your future spouse, who would you pick?	미래 배우자를 선택할 수 있다면, 누구를 선택하겠습니까?
What is something that is currently stressing you out?	현재 가장 스트레스를 받는 것은 무엇인가요?
If you had to teach a class on one thing, what would you teach?	어떤 것을 가르쳐야 한다면, 무엇을 가르치겠습니까?
What's a food that you refuse to eat?	절대 먹지 않을 음식은 무엇인가요?
What are some of your biggest pet peeves?	가장 큰 애완동물 불만은 무엇인가요?
If you could get a ticket to any show or event for free, what would you want a ticket to?	무료로 쇼나 이벤트에 갈 수 있다면, 무엇을 원하겠습니까?
What was the dumbest thing you did because of a dare?	가장 어리석은 도전은 무엇이었나요?
What movie could you watch over and over without ever getting tired of it?	몇 번이고 봐도 질리지 않는 영화는 무엇인가요?
What are some unwritten rules of where you work (or go to school)?	직장(또는 학교)에서의 비공식적인 규칙은 무엇인가요?
How many chickens would it take to kill an alligator?	몇 마리의 닭이 악어를 죽일 수 있을까요?
What past experience did you take for granted?	과거에 당연하게 여겼던 경험은 무엇인가요?
What celebrity is overrated?	가장 과대평가된 연예인은 누구인가요?
What is the most clever advertising you've seen?	가장 기발한 광고는 무엇이었나요?
Tell the group about one of your most interesting coworkers or classmates. (good or bad)	가장 흥미로운 직장 동료나 학급 친구에 대해 이야기해 보세요. (좋거나 나쁘거나)
What is one of the funniest things that happened to you in the last month?	지난달에 일어난 가장 웃긴 일은 무엇인가요?
If you could go on any reality TV show, which would you go on?	어떤 리얼리티 TV 프로그램에 참여할 수 있다면, 어떤 것을 선택하겠습니까?
If you had to choose a new name for yourself, what would it be?	새 이름을 선택해야 한다면, 무엇을 선택하겠습니까?
Who in this room are you most similar to?	이 방에서 당신과 가장 비슷한 사람은 누구인가요?
Share two truths and a lie.	진실 두 가지와 거짓말 하나를 말해 보세요.
What is something that you bring with you everywhere you go? (Other than your phone)	어디를 가든 항상 가지고 다니는 것은 무엇인가요? (휴대폰 제외)
What is something that you failed at? Did you learn any important lessons along the way?	실패한 적이 있나요? 중요한 교훈을 배웠나요?
Tell the story of your first kiss.	첫 키스의 이야기를 들려주세요.
Which is more important to you, having a great car or a great house? Why?	좋은 차를 가지는 것과 좋은 집을 가지는 것 중 어떤 것이 더 중요합니까? 이유는 무엇인가요?
What was one of your go-to movies as a child?	어린 시절의 필수 영화는 무엇이었나요?
Would you rather never be able to eat warm food or cold food?	따뜻한 음식과 차가운 음식 중 하나를 영원히 먹지 못한다면, 어떤 것을 선택하겠습니까?
What is one of the funniest dad jokes that you know?	가장 웃긴 아빠 농담은 무엇인가요?
What topics are you more knowledgeable about than most people?	다른 사람들보다 더 많이 아는 주제는 무엇인가요?
What food do you love that a lot of people might find gross?	사람들이 역겨워할 수도 있는 음식을 좋아하나요?
What's the best thing you have going on in your life at the moment?	현재 인생에서 가장 좋은 것은 무엇인가요?
What incredibly common thing have you never done?	아주 흔한 일이지만 한 번도 해보지 않은 것은 무엇인가요?
What was one of your most gullible moments?	가장 순진했던 순간은 무엇이었나요?
What band are you embarrassed to admit that you listen to?	듣는 것이 부끄러운 밴드는 무엇인가요?
What's one of the most random facts that you know?	가장 무작위적인 사실은 무엇인가요?
Who is one of your most interesting relatives?	가장 흥미로운 친척은 누구인가요?
If you were always surrounded by one scent that you and everyone around you could smell, what would it be?	주변 사람들이 모두 맡을 수 있는 냄새를 항상 맡을 수 있다면, 어떤 냄새를 선택하겠습니까?
What is one of the hardest things you've ever done?	가장 어려웠던 일은 무엇인가요?
What was one of the most influential books you've ever read?	가장 영향을 준 책은 무엇인가요?
When was the last time that you completely "lost it"?	완전히 "정신을 잃은" 마지막 순간은 언제였나요?
What is the coolest app you have on your phone?	
If you could put a new word in the dictionary, what would it be and what would be the definition?	
What was one of the funniest arguments that you've been in?	
What's the best way you or someone you know has gotten out of trouble?	
What would be the first few things you would try if you found out you could never be injured?	
Who was your most interesting teacher? (Good or bad)	
Pull out your phone and share your most used app from last week.	
Pull out your phone and read your last text out loud to the group.	
What is something funny you think about from time to time?	
What's a song that gets you motivated?	
What is a funny habit that you have?	당신이 가지고 있는 웃긴 습관은 무엇인가요?
What's one thing your mom would be embarrassed to hear you've done?	어머니가 듣고 창피해하실 만한 일을 한 적이 있나요?
Which celebrity would play you in a movie?	영화에서 당신을 연기할 연예인은 누구인가요?
Which world culture would you like to learn more about?	배우고 싶은 세계 문화는 무엇인가요?
Do you believe people have a "higher calling" in life?	사람들이 삶에서 "더 높은 소명"을 가지고 있다고 믿나요?
What's something that you are proud to have learned lately?	최근에 배운 것 중 자랑스러운 것은 무엇인가요?
Where do you find the most purpose in your life?	삶에서 가장 큰 목적을 어디에서 찾나요?
Who do you feel like you know even though you've never met them?	만난 적은 없지만 아는 것 같은 사람은 누구인가요?
What about the opposite sex confuses you the most?	이성에 대해 가장 혼란스러운 점은 무엇인가요?
What are some of the cringiest words?	가장 오글거리는 단어는 무엇인가요?
Who are some of the most intelligent people you know?	당신이 아는 가장 똑똑한 사람들은 누구인가요?
What are some of your go-to restaurants?	당신의 단골 레스토랑은 어디인가요?
If you could join one music group, past or present, which would you join?	과거 또는 현재의 음악 그룹 중 하나에 가입할 수 있다면 어디에 가입하겠습니까?
Which two people in this room are the most different?	이 방에서 가장 다른 두 사람은 누구인가요?
What is a job you think you'd be terrible at?	당신이 잘할 것 같지 않은 직업은 무엇인가요?
Which two people in this room are the most similar?	이 방에서 가장 비슷한 두 사람은 누구인가요?
Do you think you're a better or worse driver than most people in this room?	이 방의 대부분의 사람들보다 운전을 더 잘한다고 생각하나요 아니면 더 못한다고 생각하나요?
What's the best prank you've ever played on someone?	누군가에게 가장 잘 속인 장난은 무엇인가요?
How would you describe yourself in three words?	당신 자신을 세 단어로 표현한다면 무엇인가요?
If you could do anything illegal without getting in trouble, what would it be?	법에 걸리지 않고 불법적인 일을 할 수 있다면 무엇을 하겠습니까?
What's the most trouble you've ever been in?	당신이 가장 큰 곤경에 처한 적은 언제인가요?
What is the right amount of time to date someone before getting married?	결혼하기 전에 데이트하는 적절한 기간은 얼마나 되나요?
What's your favorite cheesy pick-up line?	가장 좋아하는 cheesy한 픽업 라인은 무엇인가요?
What's the funniest way that you have been injured?	가장 웃긴 부상 경험은 무엇인가요?
When was a time that you stuck your foot in your mouth?	당신이 말을 잘못한 순간은 언제인가요?
What is your funniest quirk?	가장 웃긴 버릇은 무엇인가요?
Would you consider yourself a good judge of character? Have you ever gotten someone completely wrong?	당신은 사람의 성격을 잘 판단하는 편인가요? 전혀 잘못 판단한 적이 있나요?
What is the funniest thing you have done to impress someone?	누군가를 감동시키기 위해 한 가장 웃긴 일은 무엇인가요?
What is the biggest lie you've ever told?	당신이 한 가장 큰 거짓말은 무엇인가요?
What's the longest you've gone without sleep, and why?	수면 없이 가장 오래 버틴 시간은 얼마나 되나요? 왜 그렇게 되었나요?
What is the biggest mistake you've made at work?	직장에서 저지른 가장 큰 실수는 무엇인가요?
What weird quirks or mannerisms did you pick up from your parents or guardians?	부모님이나 보호자로부터 받은 이상한 버릇이나 태도는 무엇인가요?
What fashion trend should come back?	다시 돌아왔으면 하는 패션 트렌드는 무엇인가요?
What is your spirit animal?	당신의 영혼 동물은 무엇인가요?
What are some different companies that you would like to work for? Why?	일하고 싶은 다른 회사들은 어떤 회사들인가요? 왜요?
Who is the most famous person you've ever met?	만난 적 있는 가장 유명한 사람은 누구인가요?
Would you rather have a rewind or a pause button for your life?	인생에 리와인드 또는 일시정지 버튼을 가지고 싶습니까?
What is something that really annoys you but doesn't bother most people?	다른 사람들은 신경 쓰지 않지만 당신을 정말 짜증나게 하는 것은 무엇인가요?
What are some of your nicknames?	당신의 별명은 무엇인가요?
Tell one of your best roommate stories.	가장 좋은 룸메이트 이야기를 들려주세요.
If you could steal a talent from someone, what talent would you steal and from whom?	누군가의 재능을 훔칠 수 있다면 누구의 재능을 훔치겠습니까?
Would you rather always be 10 minutes late or 30 minutes early?	항상 10분 늦게 도착하는 것과 30분 일찍 도착하는 것 중 무엇을 선택하겠습니까?
For your birthday, would you rather go somewhere or get something?	생일에 어딘가로 가는 것과 무언가를 받는 것 중 무엇을 선택하겠습니까?
What is one of the craziest things you've ever done?	가장 미친 짓을 한 적은 언제인가요?
How do you think you've changed through the years?	세월이 흐르면서 당신은 어떻게 변했나요?
If I were a car, what car would I be? (The group will answer this about you)	제가 차라면 어떤 차일까요? (그룹이 당신에 대해 답할 것입니다)
When was the closest you've ever come to dying?	죽을 뻔한 경험은 언제였나요?
If I were a pair of shoes, what kind would I be? (The group will answer this about you)	제가 신발이라면 어떤 신발일까요? (그룹이 당신에 대해 답할 것입니다)
What was your first impression of someone in this room?	이 방의 누군가에 대한 첫인상은 어땠나요?
What's the most out-of-character thing you've ever done?	가장 캐릭터에 어울리지 않는 일을 한 적이 있나요?
What is your biggest regret?	가장 큰 후회는 무엇인가요?
Who in this room would make the best president? (You can't choose yourself)	이 방에서 가장 좋은 대통령이 될 사람은 누구인가요? (당신 자신을 선택할 수 없습니다)
When was the last time you cried?	마지막으로 울었던 때는 언제였나요?
When was the last time you were really angry?	마지막으로 정말 화가 났던 때는 언제였나요?
What was one of the scariest moments of your life?	가장 무서웠던 순간은 무엇인가요?
What was one of the most awkward moments of your life?	가장 어색했던 순간은 무엇인가요?
Who here is the most likely to be two hours late to their own event?	여기에서 자신의 행사에 두 시간 늦게 올 가능성이 가장 높은 사람은 누구인가요?
Who here is the most politically correct? Who is the least politically correct?	여기에서 정치적으로 가장 올바른 사람은 누구인가요? 가장 올바르지 않은 사람은 누구인가요?
Who is someone that you completely misjudged?	완전히 잘못 판단했던 사람은 누구인가요?
Who here is most likely to open an orphanage?	여기에서 고아원을 열 가능성이 가장 높은 사람은 누구인가요?
If you could witness one event in history, what would it be?	역사 속 한 사건을 목격할 수 있다면 무엇을 선택하겠습니까?
What is the most overrated restaurant?	가장 과대평가된 레스토랑은 무엇인가요?
Would you start your life all over again if, in your new life, you would be the richest person alive?	새로운 삶에서 가장 부유한 사람이 될 수 있다면 인생을 다시 시작하시겠습니까?
What would be the most challenging thing about being the opposite sex?	이성이 되는 것에 대해 가장 어려운 점은 무엇인가요?
What is something you wish you would have known 10 years ago?	10년 전 알았으면 좋았을 것은 무엇인가요?
Who here is most likely to become an influencer?	여기에서 인플루언서가 될 가능성이 가장 높은 사람은 누구인가요?
What stereotype about you is true?	당신에 대한 고정관념 중 사실인 것은 무엇인가요?
Would you rather fight 50 duck-sized elephants or one elephant-sized duck?	오리 크기의 코끼리 50마리와 코끼리 크기의 오리 한 마리와 싸우는 것 중 무엇을 선택하겠습니까?
Pick a celebrity look-alike for each person in the room.	이 방의 각 사람에게 닮은 연예인을 선택하십시오.
If you had to compete in the Olympics tomorrow, what event do you think you could win?	올림픽에서 내일 경기에 출전해야 한다면 어떤 종목에서 이길 수 있을 것 같습니까?
Pick one word to describe each person in the room.	이 방의 각 사람을 한 단어로 설명하십시오.
What animal would be the cutest if it were the size of a rabbit?	토끼 크기의 동물 중 가장 귀여운 것은 무엇인가요?
If you could ask a question to anyone in history, who would you choose, and what question would you ask?	역사 속 누구에게 질문을 할 수 있다면 누구를 선택하겠습니까? 어떤 질문을 하겠습니까?
If you could swap bodies with any person in the world for 24 hours, who would you choose, and what would you do?	세계의 누구와 24시간 동안 몸을 바꿀 수 있다면 누구를 선택하겠습니까? 무엇을 하겠습니까?
If you could go to Mars for free, would you go? Why or why not?	화성에 무료로 갈 수 있다면 가겠습니까? 왜 또는 왜 아닙니까?
If you could know the truth about any mystery, which would it be?	어떤 미스터리의 진실을 알고 싶습니까?
What's a movie that you're embarrassed to admit you like?	당신이 좋아한다고 인정하기 부끄러운 영화는 무엇인가요?
Do you think you could do a better job than the current president? Why or why not?	현 대통령보다 더 잘할 수 있다고 생각하십니까? 왜 또는 왜 아닙니까?
If you had to trade lives with someone in this room, who would you trade with? Why?	이 방의 누군가와 인생을 바꿔야 한다면 누구와 바꾸겠습니까? 왜요?
If you could only listen to one song for the rest of your life, what would it be?	평생 하나의 노래만 들을 수 있다면 무엇을 선택하겠습니까?
Do you believe in any conspiracy theories?	어떤 음모 이론을 믿나요?
Do you believe in one or more of the following: Ghosts, aliens, Bigfoot?	다음 중 하나 이상을 믿습니까: 유령, 외계인, 빅풋?
If you didn't need to sleep at all, what would you do with all the extra time each night?	전혀 잠을 자지 않아도 된다면 매일 밤 추가 시간으로 무엇을 하겠습니까?
If you could go back in time and unquestionably win any argument you've had, what argument would you choose to win and why?	과거로 돌아가서 논쟁에서 무조건 이길 수 있다면 어떤 논쟁을 선택하고 왜 그 논쟁을 선택하겠습니까?
What social norm do you think is stupid?	어떤 사회 규범이 어리석다고 생각합니까?
What is a random fear that you have?	당신이 가진 무작위 공포는 무엇인가요?
If you could switch the sounds that two animals make, which two would you choose?	두 동물의 소리를 바꿀 수 있다면 어떤 두 동물을 선택하겠습니까?
What weird thing would you make socially acceptable if you could?	어떤 이상한 것을 사회적으로 받아들일 수 있게 만들겠습니까?
If you could be the CEO of any company, what company would you choose?	어떤 회사의 CEO가 되고 싶습니까?
Who would you bring back from the dead to live for 5 more years if you could?	죽은 사람 중 5년 더 살 수 있게 만들 사람은 누구인가요?
What was the weirdest thing you saw in someone else's home?	다른 사람의 집에서 본 가장 이상한 것은 무엇인가요?
How much of a risk-taker are you?	당신은 얼마나 위험을 감수하는 사람인가요?
What lesson did you learn the hard way?	어떤 교훈을 어려운 방법으로 배웠습니까?
What minor inconvenience enrages you?	작은 불편함이 당신을 화나게 합니까?
Have you ever had a bad roommate or house guest?	나쁜 룸메이트나 집 손님을 가진 적이 있습니까?
What is the most creative feat you've performed?	당신이 해낸 가장 창의적인 일은 무엇인가요?
Do you prefer planning things out or being spontaneous?	계획하는 것과 즉흥적인 것 중 어느 것을 선호하십니까?
Which room in your home is your favorite?	집에서 가장 좋아하는 방은 어디인가요?
What profession (different from your own) interests you?	당신의 직업과 다른 직업 중 어떤 직업이 관심이 있습니까?
If you were adopted, would you want to find your biological parents? Have you ever considered adopting?	입양되었다면 생물학적 부모를 찾고 싶습니까? 입양을 고려한 적이 있습니까?
What about being a kid do you miss the most?	아이였을 때의 어떤 점이 가장 그리운가요?
What small town do you love?	사랑하는 작은 마을은 어디인가요?
Do you operate more by your head or your heart?	당신은 머리로 더 많이 행동하나요 아니면 마음으로 더 많이 행동하나요?
Do you think the world is getting better or worse in general?	세상이 전반적으로 더 좋아지고 있다고 생각하십니까 아니면 더 나빠지고 있다고 생각하십니까?
What is missing from your life lately?	최근에 당신의 삶에서 빠진 것은 무엇인가요?
What is one of your earliest memories?	가장 어린 시절의 기억 중 하나는 무엇인가요?
Do you think it's important to contribute to society?	사회에 기여하는 것이 중요하다고 생각합니까?
Do you collect anything?	무엇을 수집합니까?
If you were the ruler of the world, what crazy stuff would you do?	세계의 지배자라면 어떤 미친 짓을 하겠습니까?
Where is your favorite spot to hang out?	가장 좋아하는 장소는 어디인가요?
What do you enjoy most about spending time with other people?	다른 사람들과 시간을 보내는 것에서 가장 즐기는 것은 무엇인가요?
What do you love about your best friend?	당신의 가장 친한 친구에 대해 무엇을 사랑합니까?
What is your favorite smell?	가장 좋아하는 냄새는 무엇인가요?
What is an opportunity you were too afraid to take?	너무 두려워서 시도하지 않은 기회는 무엇인가요?
Did you have an allowance as a kid? Do you think kids should have allowances?	어렸을 때 용돈을 받았나요? 아이들에게 용돈을 주는 것이 좋다고 생각하나요?
What's something you are grateful for?	감사한 것은 무엇인가요?
What place do you remember going to a lot as a kid?	어렸을 때 자주 갔던 장소는 어디인가요?
What's something you love that can be frustrating?	사랑하지만 짜증나는 것은 무엇인가요?
What's the best way to spend a rainy afternoon?	비 오는 오후를 보내는 가장 좋은 방법은 무엇인가요?
Do you spend more time thinking about the past, the present, or the future?	과거, 현재, 미래 중 어떤 것에 대해 더 많이 생각하십니까?
Which celebrity or influential figure would you love to have dinner with?	저녁을 함께하고 싶은 유명인 또는 영향력 있는 인물은 누구입니까?
What would you do if you woke up tomorrow and everyone else was gone?	내일 깨어났는데 다른 사람은 모두 사라졌다면 무엇을 하겠습니까?\
What was the most beautiful place you've been to?	가장 아름다운 장소는 어디였나요?
What would you name your boat if you had one?	배를 가지고 있다면 이름을 무엇으로 짓겠습니까?
What irrational fear(s) do you have?	비이성적인 두려움은 무엇인가요?
What's the weirdest thing you believed as a kid?	어렸을 때 믿었던 가장 이상한 것은 무엇인가요?
What nicknames have you had? Do you give people nicknames?	가진 별명은 무엇인가요? 사람들에게 별명을 지어주나요?
If your childhood had a defining smell, what would it be?	어린 시절의 정의하는 냄새는 무엇인가요?
What would you rate 10/10?	10점 만점에 10점을 줄 수 있는 것은 무엇인가요?
What awesome thing were you introduced to by a friend?	친구가 소개해 준 멋진 것은 무엇인가요?
Are you musically talented? How important is music in your life?	당신은 음악적 재능이 있습니까? 음악이 당신의 삶에서 얼마나 중요한가요?
What's the strangest dream you've had? Do you ever have recurring or lucid dreams?	가장 이상한 꿈은 무엇이었나요? 반복되거나 명료한 꿈을 꾸나요?
If you were to put something silly on your tombstone, what would it be?	묘비에 웃긴 것을 적는다면 무엇을 적겠습니까?
What was one of the most embarrassing things that happened to you?	가장 당황스러운 경험은 무엇이었나요?
Which store would be the worst to have a $1,000 gift card for?	$1,000 상품권을 받기 가장 싫은 가게는 어디인가요?
If you had a personal flag, what would be on it?	개인 깃발을 가지고 있다면 무엇이 그려져 있을까요?
What are you most looking forward to in the next 10 years?	향후 10년 동안 가장 기대되는 것은 무엇인가요?
When was the most inappropriate time you couldn't stop laughing?	가장 부적절한 시기에 웃음을 멈출 수 없었던 적은 언제인가요?
What was one of the weirdest conversations you've ever had?	가장 이상한 대화는 무엇이었나요?
What would you choose for your last meal?	마지막 식사로 무엇을 선택하시겠습니까?
What do you hope will never change?	변하지 않기를 바라는 것은 무엇인가요?
Are you most often honest or kind?	당신은 정직한가요 아니면 친절한가요?
What comment from a parent has stuck with you for years?	부모님의 어떤 말이 수년간 마음에 남아 있습니까?
If you were forced into a month of solitary confinement, how would you try to stay sane?	한 달 동안 독방에 갇혀 있다면 어떻게 정신을 유지하려고 노력하시겠습니까?
Would you like to be famous?	유명해지고 싶습니까?
What's the most memorable bodily function you've had?	가장 기억에 남는 신체 기능은 무엇인가요?
What do you love about your family?	가족에 대해 사랑하는 것은 무엇인가요?
Do you enjoy reading? If so, what do you like to read?	독서를 좋아합니까? 그렇다면 무엇을 읽는 것을 좋아하나요?
What did you think of me when we first met?	우리가 처음 만났을 때 저에 대해 어떻게 생각했나요?
What do you believe in despite having little or no proof?	증거가 거의 없거나 전혀 없는데도 믿는 것은 무엇인가요?
Which musical instrument do you wish you could master instantly?	즉시 마스터하고 싶은 악기는 무엇인가요?
Do you like getting advice from other people? If so, who do you go to for advice?	다른 사람들로부터 조언을 받는 것을 좋아합니까? 그렇다면 누구에게 조언을 구하나요?
Do you think humans will ever live on a planet other than Earth?	인류가 지구 외의 행성에서 살게 될 것이라고 생각하나요?
What's your favorite animated movie?	가장 좋아하는 애니메이션 영화는 무엇인가요?
What is the worst fashion trend ever?	가장 최악의 패션 트렌드는 무엇인가요?
What animal's lifestyle most closely resembles your own?	어떤 동물의 생활 방식이 당신의 생활 방식과 가장 비슷한가요?
What's your funniest substance-related story?	가장 재미있는 약물 관련 이야기는 무엇인가요?
How do you keep life in perspective?	삶을 어떻게 바라봅니까?
What person or group are you a fan of that people would be surprised to hear?	사람들이 듣고 놀랄 만한 사람이나 그룹은 누구인가요?
Who in your family would you describe as a "character"?	가족 중에 "캐릭터"로 묘사할 사람은 누구인가요?
What music makes you think of traveling?	여행을 떠올리게 하는 음악은 무엇인가요?
What's something you believe everyone should do at least once?	모든 사람들이 한 번쯤 해봐야 한다고 생각하는 것은 무엇인가요?
What do you remember about sleeping over at a friend's house when you were young?	어렸을 때 친구 집에서 자면서 기억나는 것은 무엇인가요?
If you had to change your name, what would you change it to?	이름을 바꿔야 한다면 무엇으로 바꾸겠습니까?
What's something that surprised you recently?	최근에 놀란 것은 무엇인가요?
What makes you feel old?	나이를 느끼게 하는 것은 무엇인가요?
What is bringing you the most happiness lately?	최근에 가장 큰 행복을 주는 것은 무엇인가요?
What's the bravest thing you've seen someone do?	가장 용감한 사람의 행동은 무엇이었나요?
What are your plans for the next few months?	향후 몇 개월간의 계획은 무엇인가요?
Which curse word is your favorite? Which one do you think is the most offensive?	가장 좋아하는 욕설은 무엇인가요? 가장 공격적인 욕설은 무엇이라고 생각하나요?
If you could go back in time, what's something you would undo?	과거로 돌아가서 되돌리고 싶은 것은 무엇인가요?
What's something you've learned in the last week?	지난 주에 배운 것은 무엇인가요?
What's your go-to dance move? Are you a good dancer?	가장 자주 추는 춤은 무엇인가요? 춤을 잘 추시나요?
What do you remember about your first kiss?	첫 키스에 대한 기억은 무엇인가요?
What is one of your favorite memories from early in our friendship?	우리의 우정 초기에 기억에 남는 추억은 무엇인가요?
What album or song have you listened to more than any other?	가장 많이 들은 앨범이나 노래는 무엇인가요?
What's your favorite way to exercise?	가장 좋아하는 운동 방법은 무엇인가요?
How did you get your first job? How long did you work there?	첫 직업을 어떻게 구했나요? 얼마나 오래 일했나요?
If you were to be on the news for something, what would you want the story to be about?	뉴스에 나와야 한다면 어떤 이야기를 원하시겠습니까?
What book or movie universe would you choose to live in if you could?	살고 싶은 책이나 영화 세계는 무엇인가요?
When did you take a chance or gamble that paid off?	도박이나 기회를 잡아 성공했던 적은 언제인가요?
Who is your favorite aunt or uncle?	가장 좋아하는 이모나 삼촌은 누구인가요?
Which period of your life do you look back on fondly?	가장 좋아하는 생애 시기는 언제인가요?
Do you remember getting in trouble with your parents for anything you did as a kid?	어렸을 때 부모님께 혼난 기억은 무엇인가요?
What's something that everyone looks stupid doing?	모든 사람이 바보처럼 보이는 것은 무엇인가요?
What subject would you like to learn more about?	더 알고 싶은 주제는 무엇인가요?
What movie makes you feel something no other can?	다른 영화는 어떤 느낌을 줄 수 없는 영화는 무엇인가요?
What were you obsessed with as a child?	어렸을 때 집착했던 것은 무엇인가요?
How shy are you? Why do you think that is?	당신은 얼마나 내성적입니까? 왜 그렇게 생각하나요?
What activity could you happily do for hours and hours?	몇 시간이고 행복하게 할 수 있는 활동은 무엇인가요?
How did your parents decide what to name you?	부모님이 당신의 이름을 어떻게 지었나요?
What's worth spending more money on to get the best?	최고의 것을 얻기 위해 더 많은 돈을 쓸 만한 것은 무엇인가요?
How useful would you be in a zombie apocalypse?	좀비 아포칼립스에서 얼마나 유용할 것 같습니까?
Have you fallen for a scam before? If so, what happened? If not, how do you avoid them?	사기를 당한 적이 있습니까? 그렇다면 무슨 일이 있었나요? 아니라면 어떻게 피하나요?
How many pets have you had, and what were their names?	애완동물을 몇 마리 키웠습니까? 이름은 무엇이었나요?
What happened in the last week that annoyed you?	지난 주에 당신을 짜증나게 한 일은 무엇인가요?
What do you like about where you live?	당신이 사는 곳에 대해 좋아하는 점은 무엇인가요?
What do you think was unique about your upbringing?	당신의 성장 배경에서 독특했던 것은 무엇인가요?
Who was your first celebrity crush?	첫 번째 연예인 짝사랑은 누구였나요?
What's your favorite dinosaur? WHat's your favorite animal? Why?	가장 좋아하는 공룡은 무엇인가요? 가장 좋아하는 동물은 무엇인가요? 왜요?
What do you want to make more time for?	더 많은 시간을 내고 싶은 것은 무엇인가요?
What's the most expensive thing you've broken?	깨진 가장 비싼 것은 무엇인가요?
What has forced you to grow recently?	최근에 당신을 성장하게 한 것은 무엇인가요?
How do you like to relax?	어떻게 휴식을 취하는 것을 좋아하나요?
Which of your scars has the best story behind it?	가장 좋은 이야기가 담긴 흉터는 무엇인가요?
What might you miss in the future about your current lifestyle?	미래에 현재 생활 방식에 대해 그리워할 것은 무엇인가요?
What life lesson did you learn as a kid that impacts who you are today?	어린 시절에 배운 인생 교훈 중 오늘날 당신에게 영향을 미치는 것은 무엇인가요?
Who would you enjoy slapping across the face if there were no negative consequences?	부정적인 결과가 없다면 누구를 한 번 때리고 싶습니까?
What invention would you offer a $20,000,000 development prize for if you had the money?	$20,000,000 개발 상금을 제안하고 싶은 발명품은 무엇인가요?
What was your worst road trip? What happened?	최악의 도로 여행은 무엇이었나요? 무슨 일이 있었나요?
When did you have to learn very quickly?	아주 빨리 배워야 했던 적은 언제인가요?
Would you want to live forever if your body didn't get old?	몸이 늙지 않는다면 영원히 살고 싶습니까?
What do you think future societies will find interesting or funny about how we live now?	미래 사회가 우리가 지금 살고 있는 방식에 대해 흥미롭거나 재미있다고 생각할 것은 무엇인가요?
What's something you learned while traveling?	여행 중 배운 것은 무엇인가요?
Who's your favorite author or film director? What makes him or her your favorite?	가장 좋아하는 작가나 영화 감독은 누구인가요? 그가 당신의 가장 좋아하는 이유는 무엇인가요?
Who had the biggest impact on your career choice?	당신의 경력 선택에 가장 큰 영향을 미친 사람은 누구인가요?
What do you spend the most time thinking about?	가장 많이 생각하는 것은 무엇인가요?
Have you ever stood up to a bully?	괴롭힘을 당한 적이 있나요?
What do you want from life?	삶에서 원하는 것은 무엇인가요?
What's the ugliest item of clothing you've ever worn or owned?	가장 못생긴 의류 품목은 무엇인가요?
What's your favorite thing about coming home after a long trip?	긴 여행 후 집에 돌아오는 것에 대해 가장 좋아하는 점은 무엇인가요?
When did you feel deeply appreciated by someone else?	다른 사람에게 깊이 감사했던 순간은 언제인가요?
Who is your all-time favorite artist (actor, author, musician, painter, etc.)?	가장 좋아하는 예술가(배우, 작가, 음악가, 화가 등)는 누구인가요?
What do you regularly spend too much money on?	정기적으로 너무 많은 돈을 쓰는 것은 무엇인가요?
How did you spend time with your siblings (or cousins if you are an only child) when you were little?	어렸을 때 형제자매(또는 외동이라면 사촌)와 시간을 어떻게 보냈나요?
What event would you like to attend one day?	언젠가 참석하고 싶은 행사는 무엇인가요?
Do you have a passion? If so, what? If not, do you wish you had one?	열정이 있습니까? 있다면 무엇입니까? 없다면 열정이 있기를 바라나요?
What's the most significant number in your life?	당신의 삶에서 가장 중요한 숫자는 무엇인가요?
What is the most impressive athletic feat you've performed?	가장 인상적인 운동 성과는 무엇인가요?
Would you rather have a personal chef or a maid?	개인 셰프나 가정부 중 누구를 선택하시겠습니까?
What was your favorite childhood meal?	어린 시절 가장 좋아했던 음식은 무엇인가요?
How is your life different from how you thought it would be?	당신의 삶이 생각했던 것과 어떻게 다른가요?
What's the worst chore?	가장 싫어하는 집안일은 무엇인가요?
Who is the most mysterious person you know?	가장 신비로운 사람은 누구인가요?
Are you good at dealing with uncertainty?	불확실성을 잘 다루십니까?
How would you spend your time if you had $10,000,000 in the bank?	은행에 $10,000,000이 있다면 시간을 어떻게 보내겠습니까?
How important are first impressions? When did you make a bad first impression?	첫인상은 얼마나 중요한가요? 첫인상을 잘못 만든 적이 있습니까?
Which holiday would you get rid of if you could?	없앨 수 있다면 어떤 휴일을 없애겠습니까?
Would you rather go to space or the bottom of the ocean?	우주로 가는 것과 바다 밑으로 가는 것 중 무엇을 선택하시겠습니까?
What was the best thing you bought at a yard sale?	야드 세일에서 산 최고의 물건은 무엇인가요?
What's your favorite local event in your hometown?	고향에서 가장 좋아하는 지역 행사는 무엇인가요?
Do you enjoy the outdoors? How much camping have you done?	야외 활동을 즐기십니까? 캠핑을 얼마나 많이 해보셨나요?
What do you get more afraid of as you get older?	나이가 들면서 더 두려워지는 것은 무엇인가요?
If you had a warning label, what would it say?	경고 라벨을 가지고 있다면 무엇을 쓸 것인가요?
Which 2 people (that you actually know) would team up with to try to survive an apocalypse?	종말을 생존하기 위해 함께 팀을 이루고 싶은 실제로 아는 두 사람은 누구인가요?
What do you waste a lot of time on?	많은 시간을 낭비하는 것은 무엇인가요?
What's the most obscure subject you're interested in?	가장 특이한 관심사는 무엇인가요?
What was the worst day of school you ever had?	학교에서 가장 나빴던 날은 무엇인가요?
What do you miss about a job you once had?	한 번 했던 직업에 대해 그리운 점은 무엇인가요?
What was the most dangerous thing you've done?	가장 위험한 일은 무엇이었나요?
What was your favorite subject in school? What was your least favorite?	학교에서 가장 좋아했던 과목은 무엇인가요? 가장 싫어했던 과목은 무엇인가요?
What's one of your best memories of your mom?	어머니에 대한 최고의 기억은 무엇인가요?
What was one of the most embarrassing things you did in front of someone you had a crush on?	당신이 좋아하는 사람 앞에서 가장 당황스러운 일은 무엇이었나요?
There are two types of people in this world. What are they?	이 세상에는 두 종류의 사람이 있습니다. 그것은 무엇입니까?
What fear have you overcome?	극복한 두려움은 무엇인가요?
Where are you no longer welcome? How do you know?	더 이상 환영받지 못하는 곳은 어디인가요? 어떻게 알았습니까?
What job would you be terrible at?	당신이 잘할 것 같지 않은 직업은 무엇인가요?
How did you meet your first romantic interest?	첫 연인을 어떻게 만났나요?
If you could become the number one expert in a field, which field would you choose?	한 분야에서 최고의 전문가가 될 수 있다면 어떤 분야를 선택하시겠습니까?
What were you like during high school?	고등학교 시절 당신은 어떤 사람이었나요?
Who is the most patient person you know? Do you wish you were more patient?	가장 인내심이 많은 사람은 누구인가요? 더 인내심이 많기를 바라나요?
What was the furthest away from home you've ever been?	가장 멀리 간 곳은 어디인가요?
What do people need to do to gain your trust?	사람들이 당신의 신뢰를 얻기 위해 해야 할 일은 무엇인가요?
Do you have any cleanliness pet peeves?	청결에 대한 애착이 있습니까?
What game or sport matters the most to you?	당신에게 가장 중요한 게임이나 스포츠는 무엇인가요?
What single word best describes you?	당신을 가장 잘 설명하는 단어는 무엇인가요?
What motivates you to do good work?	좋은 일을 하도록 동기를 부여하는 것은 무엇인가요?
What movie monster scares you the most?	가장 무서운 영화 괴물은 무엇인가요?
Which other language would you like to know?	어떤 언어를 배우고 싶나요?
Who is your ideal travel companion? What makes you a good person to travel with?	이상적인 여행 동반자는 누구인가요? 당신이 여행하기 좋은 사람인 이유는 무엇인가요?
What's your favorite way to meet new people?	새로운 사람을 만나는 가장 좋아하는 방법은 무엇인가요?
What choice did you make that your family disapproved of?	가족이 반대한 선택은 무엇인가요?
What is your guilty pleasure?	당신의 죄책감은 무엇인가요?
What were you nervous about but actually turned out well?	긴장했지만 실제로 잘 풀린 것은 무엇인가요?
What's your favorite day of the week? What's your favorite month of the year?	가장 좋아하는 요일은 무엇인가요? 가장 좋아하는 달은 무엇인가요?
What is something you absolutely wouldn't eat?	절대 먹지 않을 것은 무엇인가요?
What's your favorite flower or plant?	가장 좋아하는 꽃이나 식물은 무엇인가요?
How would you live differently if all electronics stopped working forever?	모든 전자 제품이 영원히 작동하지 않는다면 어떻게 다르게 살겠습니까?
If you could get one law passed, what would it be?	하나의 법을 통과시킬 수 있다면 무엇을 통과시키겠습니까?
What's the worst city or town you've ever been in?	가장 싫었던 도시나 마을은 어디인가요?
What is one fictional food you'd like to try?	시도해보고 싶은 허구의 음식은 무엇인가요?
What's one of your best memories of one of your grandfathers?	할아버지와 함께한 최고의 기억은 무엇인가요?
If you could move to any other country, where would you go?	다른 나라로 이사할 수 있다면 어디로 가겠습니까?
What's one of your most vivid memories from elementary school?	당신의 초등학교 시절 가장 생생한 기억은 무엇인가요?
What is your least favorite movie genre?	가장 싫어하는 영화 장르는 무엇인가요?
Is there something you wanted to happen but disliked once it did?	바라던 일이 있었는데, 막상 일어나고 나니 싫었던 일이 있나요?
What's an uncomfortable thing you had to tell someone?	누군가에게 말하기 불편했던 일이 있었나요?
Who is your earliest ancestor that you know something about?	당신이 알고 있는 가장 이른 조상은 누구입니까?
What's your biggest opportunity in your life right now?	지금 당신의 삶에서 가장 큰 기회는 무엇인가요?
What did you do as a child that your parents still talk about?	어렸을 때 부모님이 여전히 이야기하는 것은 무엇인가요?
How important is happiness? Are some things even more important?	행복은 얼마나 중요한가요? 더 중요한 것이 있나요?
What is your most treasured possession? Why is it important to you?	가장 소중한 소유물은 무엇인가요? 왜 그것이 중요한가요?
What is your proudest accomplishment?	가장 자랑스러운 성취는 무엇인가요?
What's the most surreal or unexplainable thing you've experienced?	가장 초현실적이거나 설명할 수 없는 경험은 무엇인가요?
What was the best meal you've ever had?	가장 맛있었던 식사는 무엇인가요?
What's one thing you like about your country?	당신이 좋아하는 나라의 한 가지는 무엇인가요?
What surprises you the most about people?	사람들에 대해 가장 놀라운 점은 무엇인가요?
If you were going to start a business, what kind would it be?	사업을 시작한다면 어떤 종류의 사업을 하겠습니까?
What do you enjoy most about traveling? Or if you don't like traveling, why not?	여행에서 가장 즐기는 점은 무엇인가요? 여행을 좋아하지 않는다면 그 이유는 무엇인가요?
What's special about your dream home?	당신의 꿈의 집이 특별한 점은 무엇인가요?
What was your favorite thing about elementary school?	초등학교에서 가장 좋아했던 것은 무엇인가요?
What's the worst song in the world?	세상에서 가장 나쁜 노래는 무엇인가요?
What memorable gift have you received or given?	기억에 남는 선물은 무엇인가요?
What was one thing you liked about your first car?	첫 차에 대해 좋아했던 점 하나는 무엇인가요?
What are you picky about?	당신이 까다롭게 구는 것은 무엇인가요?
What trip or travel experience has most affected your life so far?	가장 인상 깊었던 여행 경험은 무엇인가요?
Who do you know who lives life to the fullest?	삶을 가장 풍부하게 사는 사람은 누구인가요?
What kind of museum would you open if you were given the money for it?	돈이 주어진다면 어떤 종류의 박물관을 열겠습니까?
If you could know the absolute truth about one question, what would you ask?	하나의 질문에 대한 절대적인 진실을 알 수 있다면 무엇을 묻겠습니까?
What's the worst part of your average day?	평균 하루 중 가장 안 좋은 부분은 무엇인가요?
What do you look forward to about getting old?	나이가 들면서 기대되는 것은 무엇인가요?
What was the most unlikely crowd of people you hung out with?	가장 의외의 사람들과 어울렸던 적은 언제였나요?
How would you describe your childhood?	당신의 어린 시절을 어떻게 설명하시겠습니까?
What kind of music do you like? How have your tastes changed over time?	어떤 종류의 음악을 좋아하나요? 시간이 지남에 따라 취향이 어떻게 변했나요?
Would you like to travel more or less than you currently do?	현재보다 여행을 더 많이 하고 싶나요, 덜 하고 싶나요?
What was a stupid thing you convinced a friend to do?	친구에게 설득해서 하게 한 가장 어리석은 일은 무엇인가요?
What's the most important trait for a friend to have?	친구에게 가장 중요한 특성은 무엇인가요?
What childish thing do you still enjoy?	아직도 즐기는 어린애 같은 것은 무엇인가요?
Who intimidates you or is hard to measure up to?	당신을 겁먹게 하거나 측정하기 어려운 사람은 누구인가요?
What was the best compliment you ever received?	가장 기억에 남는 칭찬은 무엇인가요?
What should people say to each other more often?	사람들이 더 자주 서로에게 해야 할 말은 무엇인가요?
What do you love about your favorite restaurant?	가장 좋아하는 레스토랑에 대해 무엇을 사랑하나요?
What book, TV show, movie, or music has had the biggest impact on you?	당신에게 가장 큰 영향을 미친 책, TV 프로그램, 영화, 음악은 무엇인가요?
What's the #1 thing on your bucket list?	버킷리스트에서 가장 중요한 것은 무엇인가요?
What's your favorite big city?	가장 좋아하는 대도시는 어디인가요?
Do you believe in love at first sight?	첫눈에 반하는 사랑을 믿나요?
When did you accomplish a New Years Resolution or goal that was important to you?	중요한 새해 결심이나 목표를 달성한 적이 있나요?
What would you do with an extra $100 of spending money per week?	매주 추가로 $100의 용돈이 생긴다면 무엇을 하겠습니까?
When were you the sickest you've ever been?	가장 아팠던 때는 언제였나요?
Do you think you would be a good teacher? Which subject would you teach?	좋은 선생님이 될 것 같나요? 어떤 과목을 가르치겠습니까?
Would you want to be on a TV game show? Which one?	TV 게임 쇼에 출연하고 싶습니까? 어떤 쇼에 출연하고 싶습니까?
What's something you will NEVER do again?	다시는 하지 않을 일은 무엇인가요?
Have you ever almost died from awkwardness?	곤란함으로 거의 죽을 뻔한 적이 있습니까?
What superpower would you love to have?	갖고 싶은 초능력은 무엇인가요?
Did you have a secret hiding place when you were a kid?	어렸을 때 비밀 은신처가 있었나요?
What is your favorite sound? What sound drives you insane?	가장 좋아하는 소리는 무엇인가요? 미치게 하는 소리는 무엇인가요?
Do you have a dream car? If not, what would a car specifically designed for you be like?	꿈의 차가 있나요? 없다면 당신을 위해 설계된 차는 어떤 모습일까요?
Which character trait is good until someone exhibits too much of it?	어떤 성격 특성은 적당하면 좋지만 과하면 안 좋은가요?
Are you good at cheering people up? If so, how do you do it?	사람들을 기분 좋게 만드는 데 능숙한가요? 그렇다면 어떻게 합니까?
What's one thing you wish you had known as a child?	어렸을 때 알았으면 좋았을 것은 무엇인가요?
What did you like about the neighborhood where you grew up?	자라난 동네에 대해 좋아했던 점은 무엇인가요?
What do you think in our world would be the best part of having kids?	세상에서 아이를 가지는 것의 가장 좋은 점은 무엇인가요?
When do you feel most connected to others?	언제 다른 사람들과 가장 연결된다고 느끼나요?
Who is your favorite historical figure?	가장 좋아하는 역사적 인물은 누구인가요?
What thing did you have the most fun learning with someone else?	다른 사람과 함께 배우면서 가장 재미있었던 것은 무엇인가요?
What did you want to be when you were 10 years old?	10살 때 되고 싶었던 것은 무엇인가요?
What conversation would you like to have listened in on?	들어보고 싶은 대화는 무엇인가요?
What's your most common first thought when you wake up?	일어나자마자 가장 자주 하는 첫 번째 생각은 무엇인가요?
Were you scared there was a monster under your bed when you were little?	어렸을 때 침대 아래에 괴물이 있다고 무서워했던 적이 있나요?
What was the biggest fiasco you participated in?	참여했던 가장 큰 소동은 무엇인가요?
What will your next big purchase be?	다음 큰 구매는 무엇이 될 것 같나요?
What movie do you quote from regularly?	정기적으로 인용하는 영화는 무엇인가요?
When was the last time you changed your style? Why?	스타일을 마지막으로 바꾼 때는 언제였나요? 왜 바꿨나요?
What's one of your best memories of one of your grandmothers?	할머니에 대한 최고의 기억은 무엇인가요?
What's your favorite holiday memory?	가장 좋아하는 휴일 기억은 무엇인가요?
When do you feel most alive?	언제 가장 살아있는 느낌이 드나요?
When were you horribly late to something? Are you normally a punctual person?	무언가에 엄청 늦었던 적이 있나요? 보통 시간을 잘 지키는 사람인가요?
What was one of the best years of your life?	당신의 삶에서 최고의 해 중 하나는 언제였나요?
What's one thing you hate about technology? What's one thing you love about technology?	기술에 대해 싫어하는 한 가지는 무엇인가요? 기술에 대해 좋아하는 한 가지는 무엇인가요?
How can someone completely lose your respect?	누군가가 완전히 당신의 존경을 잃게 만드는 것은 무엇인가요?
What is your favorite ice cream topping?	가장 좋아하는 아이스크림 토핑은 무엇인가요?
What has been one of the most stressful situations for you over the years?	오랜 시간 동안 가장 스트레스를 받은 상황은 무엇인가요?
How do you approach small talk? Would you say you're good at it?	작은 대화를 어떻게 접근합니까? 작은 대화를 잘한다고 생각하십니까?
Do you believe in the supernatural (ghosts, UFOs, etc.)? How do you feel about haunted places?	초자연적 현상(유령, UFO 등)을 믿습니까? 유령이 나오는 장소에 대해 어떻게 생각합니까?
Who pushes your buttons the most?	가장 화나게 만드는 사람은 누구인가요?
How did you get started in your current, most important endeavor?	현재 가장 중요한 일에 어떻게 발을 들이게 되었나요?
When did someone stand up for you or fight for you?	누군가가 당신을 위해 싸우거나 당신을 위해 일어섰던 적이 있나요?
WHich of your personality traits gets you in the most trouble?	당신의 성격 특성 중 가장 문제가 되는 것은 무엇인가요?
How often do you feel bored? What do you usually do about it?	얼마나 자주 지루함을 느끼나요? 보통 어떻게 대처하나요?
What was a great vacation you went on in the last 5 years?	지난 5년 동안 갔던 좋은 휴가는 무엇인가요?
What have you done that most people haven't?	대부분의 사람들이 해본 적 없는 일을 해본 적이 있나요?
If you could invent something that only we could use, what would it be?	우리만 사용할 수 있는 것을 발명할 수 있다면 무엇을 만들겠습니까?
How much of a "homebody" are you? How often do you want to have a night out?	얼마나 집에 있는 것을 좋아합니까? 얼마나 자주 외출하고 싶습니까?
When were you embarrassed for someone else?	다른 사람 때문에 창피했던 적은 언제인가요?
What chance encounter changed your life forever?	우연히 만난 일이 당신의 삶을 영원히 바꾼 적은 언제인가요?
What topic could you spend hours talking about?	오래 이야기할 수 있는 주제는 무엇인가요?
What food do you eat in a weird way? What food is delicious but a pain to eat?	이상하게 먹는 음식은 무엇인가요? 맛있지만 먹기 힘든 음식은 무엇인가요?
When was the most peaceful time in your life?	가장 평화로웠던 시기는 언제였나요?
What board game or video game do you hate?	가장 싫어하는 보드 게임이나 비디오 게임은 무엇인가요?
Do you wish you were more confident? Why or why not?	자신감이 더 있기를 바라나요? 그렇다면 왜 그렇습니까? 아니면 왜 그렇지 않습니까?
Which fast food restaurant is the best? Which one is the worst?	가장 좋아하는 패스트푸드 레스토랑은 어디인가요? 가장 싫어하는 곳은 어디인가요?
When did you realize something wasn't for you?	무언가가 자신에게 맞지 않다는 것을 언제 깨달았나요?
Would you rather watch the sunrise, sunset, or night sky?	일출, 일몰, 또는 밤하늘 중 무엇을 보고 싶습니까?
What was the happiest day of your life?	당신의 삶에서 가장 행복한 날은 언제였나요?
Are you a team player or more of a lone wolf?	팀 플레이어인가요 아니면 혼자 일하는 편인가요?
How fashionable are you? How would you describe your style?	패션 감각이 있나요? 당신의 스타일을 어떻게 설명하시겠습니까?
Have you ever lied to your parents? If so, what about? Did you get away with it?	부모님에게 거짓말을 한 적이 있습니까? 만약 그렇다면 무엇에 대해 거짓말했나요? 들키지 않았나요?
What was the worst phase you went through?	가장 최악의 시기는 무엇이었나요?
Which animal scares you the most?	가장 무서운 동물은 무엇인가요?
Who is the happiest person you know? How can you tell?	당신이 아는 가장 행복한 사람은 누구인가요? 어떻게 알 수 있나요?
What always sounds like a good idea at the time but rarely is?	항상 좋은 생각 같지만 드물게 좋은 생각인 것은 무엇인가요?
How much do you care about what others think of you?	다른 사람들이 당신에 대해 어떻게 생각하는지 얼마나 신경 쓰나요?
What did you quit but wish you didn't?	그만두었지만 후회하는 것은 무엇인가요?
What TV show has a special place in your heart? Why?	마음에 특별한 자리를 차지하고 있는 TV 쇼는 무엇인가요? 왜요?
What do you strongly dislike even though most people enjoy it?	대부분의 사람들이 즐기는 것을 강하게 싫어하는 것은 무엇인가요?
What event helped you mature as a person?	당신이 성숙해지는 데 도움을 준 사건은 무엇인가요?
What was one of the most fun things you did in the last month?	지난 한 달 동안 가장 재미있었던 일은 무엇인가요?
Can you happily watch the same movie or read the same book multiple times in one year?	하나의 영화를 여러 번 보거나 하나의 책을 여러 번 읽는 것을 즐기나요?
What's something you can never seem to finish? Do you think of yourself as a procrastinator?	항상 끝내지 못하는 것은 무엇인가요? 자신을 미루는 사람이라고 생각합니까?
What was the most ridiculous purchase you made?	가장 터무니없는 구매는 무엇이었나요?
What's invisible but you wish people could see?	눈에 보이지 않지만 사람들이 볼 수 있으면 좋겠다고 생각하는 것은 무엇인가요?
Where was a place you visited that smelled horrible?	방문한 장소 중 냄새가 끔찍했던 곳은 어디인가요?
What do you hope people will say about you at your funeral?	당신의 장례식에서 사람들이 무엇을 말해주길 바라나요?
Do you think people are basically good?	사람들이 기본적으로 선하다고 생각합니까?
What was the best thing that happened to you today?	오늘 당신에게 일어난 가장 좋은 일은 무엇인가요?
What's your ideal social outing?	이상적인 사회적 외출은 무엇인가요?
How much do you know about the world outside of your country?	당신의 나라 밖의 세계에 대해 얼마나 알고 있습니까?
What do you want to do in the next year that you've never done before?	다음 해에 한 번도 해본 적 없는 일을 하고 싶습니까?
If you didn't have to sleep, what would you do at night?	잠을 자지 않아도 된다면 밤에 무엇을 하겠습니까?
What is a luxury that you really enjoy?	정말 즐기는 사치는 무엇인가요?
What do you think makes you unique?	당신을 독특하게 만드는 것은 무엇인가요?
Who do you wish you could have as a mentor for one year?	1년 동안 멘토로 삼고 싶은 사람은 누구인가요?
Who is or was your favorite older person?	당신이 가장 좋아하는 연장자 (부모님, 할아버지/할머니 등)는 누구인가요?\
What is your favorite art style or piece of art?	가장 좋아하는 예술 스타일이나 예술 작품은 무엇인가요?
What has inspired you recently?	최근에 영감을 받은 것은 무엇인가요?
When were you proud of someone?	누군가를 자랑스럽게 여겼던 순간은 언제인가요?
What are people most likely to get wrong about you?	사람들이 당신에 대해 가장 잘못 알고 있는 것은 무엇인가요?
What does the world need more of?	세상에 더 필요한 것은 무엇인가요?
What do you have a bad attitude about?	당신이 가진 나쁜 태도는 무엇인가요?
How were you different 5 years ago?	5년 전과 비교했을 때 어떻게 달라졌나요?
Do you wish you were better at letting loose and having fun?	더 자유롭고 재미있게 놀기를 바라나요?
What lesson could others learn from your life?	다른 사람들이 당신의 삶에서 배울 수 있는 교훈은 무엇인가요?
What was the best thing that happened to you in the last year? What was the worst thing?	지난 해에 일어난 가장 좋은 일은 무엇인가요? 가장 나쁜 일은 무엇인가요?
How often is your brain on autopilot?	얼마나 자주 당신의 뇌가 자동 조종 모드에 있습니까?
What's something on your phone or computer that you can do for hours?	당신의 휴대폰이나 컴퓨터에서 몇 시간 동안 할 수 있는 것은 무엇인가요?
What's something funny that happened when you were a kid?	어렸을 때 일어난 재미있는 일은 무엇인가요?
Which fictional character do you think you could be really good friends with?	어떤 가상의 캐릭터와 가장 친하게 지낼 수 있을 것 같나요?
What topic would you cover if you had a YouTube channel, podcast, or blog?	유튜브 채널, 팟캐스트, 블로그를 한다면 어떤 주제를 다루고 싶나요?
What hobby have you been doing consistently for the longest time?	가장 오랫동안 꾸준히 해온 취미는 무엇인가요?
If you could magically eradicate one world problem, which one would you pick?	마법처럼 한 가지 세계 문제를 해결할 수 있다면 무엇을 선택하겠습니까?
What should parents stop teaching their kids?	부모님들이 아이들에게 가르치지 말아야 할 것은 무엇인가요?
Have you ever won an award? How did you feel about it?	상을 받은 적이 있나요? 그것에 대해 어떻게 느꼈나요?
What was something you thought would be easy until you tried it?	쉽다고 생각했지만 시도해보니 어려웠던 것은 무엇인가요?
How do you deal with difficult people?	어려운 사람들을 어떻게 대처하나요?
What blows your mind every time you think about it?	생각할 때마다 놀라운 것은 무엇인가요?
What dream have you given up on?	포기한 꿈은 무엇인가요?
What small thing can a person do to greatly improve his or her life?	사람이 인생을 크게 개선할 수 있는 작은 일은 무엇인가요?
What is your favorite breakfast cereal and why?	가장 좋아하는 아침 시리얼은 무엇이며, 왜 좋아하나요?
What skill do you wish you could instantly master?	즉시 마스터하고 싶은 기술은 무엇인가요?
What's something very few people know about you?	다른 사람들이 거의 모르는 것은 무엇인가요?
Where was the fanciest bed you've slept in?	가장 호화로운 침대는 어디에서 잤나요?
What's the most interesting object in your bedroom?	침실에서 가장 흥미로운 물건은 무엇인가요?
What comforts you when you're sad?	슬플 때 무엇이 위로가 되나요?
What's one of your best memories of your dad?	아빠에 대한 최고의 기억 중 하나는 무엇인가요?
Where would you like to retire, and what would you do in retirement?	어디에서 은퇴하고 싶으며 은퇴 후 무엇을 하고 싶나요?
Would you rather be the funniest or smartest person in the room?	방 안에서 가장 웃기거나 가장 똑똑한 사람이 되고 싶나요?
Who was your favorite teacher? What made them special?	가장 좋아하는 선생님은 누구였나요? 그들을 특별하게 만든 것은 무엇인가요?
Would you rather live in the city or the countryside?	도시에서 살고 싶나요, 아니면 시골에서 살고 싶나요?
What is the most excruciating pain you've ever experienced?	가장 극심한 통증은 무엇이었나요?
What's your favorite thing to shop for? Least favorite?	가장 쇼핑하기 좋아하는 것과 싫어하는 것은 무엇인가요?
What was the worst team you've been on? What was the best?	가장 나쁜 팀과 가장 좋은 팀은 무엇이었나요?
What was your most memorable birthday?	가장 기억에 남는 생일은 무엇인가요?
Is there a place that was special to you that has gone out of business or no longer exists?	특별했던 장소가 문을 닫았거나 더 이상 존재하지 않는 경우가 있나요?
If you could talk to animals, which animal would you most want to talk to?	동물과 대화할 수 있다면 어떤 동물과 가장 대화하고 싶나요?
Who pushes you to be a better person?	당신을 더 나은 사람으로 밀어붙이는 사람은 누구인가요?
Have you ever been in a fistfight? Over what and what happened?	주먹다짐을 한 적이 있나요? 그 이유와 결과는 무엇인가요?
Where would you love to vacation for one month if it was entirely free?	한 달 동안 무료로 휴가를 보낼 수 있다면 어디에서 보내고 싶나요?
To what extent do you think people can change?	사람들이 얼마나 변할 수 있다고 생각하나요?
What was the worst job you ever had?	가장 나쁜 직업은 무엇이었나요?
Where is the most secluded place you've ever been?	가장 외진 곳은 어디였나요?
What historical period do you find most interesting?	가장 흥미로운 역사적 시대는 무엇인가요?
How competitive are you? Do you see that as a positive or a negative?	경쟁적인 성격인가요? 이를 긍정적으로 보나요, 부정적으로 보나요?
How would you describe how you see the world in one sentence?	세상을 한 문장으로 어떻게 보나요?
How would you live differently if you knew you'd die in exactly one year?	정확히 1년 후에 죽는다면 어떻게 다르게 살 것인가요?
What was the weirdest food you ever ate?	가장 이상한 음식은 무엇이었나요?
What's the longest you've stayed awake?	가장 오랫동안 깨어 있었던 시간은 얼마나 되나요?
What scares you most about your current job or project?	현재 직업이나 프로젝트에서 가장 두려운 것은 무엇인가요?
What's a lost object that you'd love to have back?	잃어버린 물건 중 되찾고 싶은 것은 무엇인가요?
How many hours of sleep per night do you need to feel good? Do you like naps?	좋은 느낌을 받기 위해 밤에 몇 시간의 수면이 필요합니까? 낮잠을 좋아합니까?
How has someone touched your heart?	어떤 사람이 당신의 마음을 감동시켰나요?
What is someone meeting you for the first time probably going to like about you?	처음 만나는 사람이 아마도 당신에 대해 좋아할 것은 무엇인가요?
Who is the best storyteller you know? What makes their stories so good?	최고의 이야기꾼은 누구인가요? 그들의 이야기가 좋은 이유는 무엇인가요?
Have you lost a friendship that you wish was still strong?	잃어버린 우정을 아직도 그리워하나요?
What's the recipe for a rich life?	풍요로운 삶을 위한 비결은 무엇인가요?
If you could teleport between exactly two locations as often as you wanted, which two would you choose?	두 위치 사이를 마음껏 텔레포트할 수 있다면 어떤 위치를 선택할까요?
How do you think you could be a better friend?	더 나은 친구가 되기 위해 어떻게 할 수 있을까요?
Who did you become friends with surprisingly quickly?	놀랍도록 빨리 친구가 된 사람은 누구인가요?
What have you learned from dating or being in a relationship?	연애나 관계에서 배운 것은 무엇인가요?
What useful class should all public school students have to take?	모든 공립학교 학생이 반드시 들어야 할 유용한 수업은 무엇인가요?
What happens more often than you'd like?	생각보다 더 자주 일어나는 일은 무엇인가요?
What was the best or worst advice you ever received?	가장 좋은 조언이나 가장 나쁜 조언은 무엇이었나요?
Are you usually too quick or too slow to judge people?	사람들을 판단하는 데 너무 빠르거나 너무 느리진 않나요?
Is there a food you could happily eat every day of your life?	매일 행복하게 먹을 수 있는 음식이 있나요?
Which culture do you find fascinating?	매력적인 문화는 무엇인가요?
How are people of different generations similar to, or different from each other?	다른 세대의 사람들은 서로 어떻게 비슷하고 다릅니까?
How much physical contact do you have with others? Hugs, handshakes, pats on the back, etc?	다른 사람들과의 신체 접촉은 얼마나 되나요? 포옹, 악수, 등을 두드리기 등.
What's an unusual way that you've made money?	이상한 방식으로 돈을 번 적이 있나요?
How often do you try new or uncomfortable things? What's a recent example?	새로운 것이나 불편한 것을 얼마나 자주 시도합니까? 최근의 예는 무엇인가요?
What do you think about intuition, or "following your gut"?	직감이나 '느낌을 따르는 것'에 대해 어떻게 생각하나요?
What could you talk about for hours?	몇 시간 동안 이야기할 수 있는 것은 무엇인가요?
What are the most adventurous things you've done?	가장 모험적인 일들은 무엇인가요?
How has your life changed in the past five years?	지난 5년 동안 당신의 삶은 어떻게 변했나요?
What are your thoughts on traditional gender roles, occupations, chivalry, etc?	전통적인 성 역할, 직업, 기사도 등에 대해 어떻게 생각합니까?
Describe the first hour of your typical day.	일반적인 하루의 첫 시간을 설명하세요.
You can have $10 million today, or 5 healthy years added to your life. Which will you choose?	오늘 1천만 달러를 받거나 건강한 5년을 추가로 받는다면 무엇을 선택할까요?
What will future generations find amazing or ridiculous about our current times?	미래 세대가 현재 우리 시대에 대해 놀라거나 우스꽝스럽다고 생각할 것은 무엇인가요?
What big task or project did it feel fantastic to complete?	완수하기에 기분이 좋았던 큰 작업이나 프로젝트는 무엇인가요?
When have you been in a scary or dangerous situation?	무서운 상황이나 위험한 상황에 처한 적이 있나요?
Who has always been there for you?	항상 당신 곁에 있어준 사람은 누구인가요?
Do you have any irrational fears? If so, do you know why?	비이성적인 두려움이 있나요? 만약 있다면 왜 그런지 아십니까?
What do you think of the occult; astrology, magic, psychics, etc?	점성술, 마술, 영매 등 오컬트에 대해 어떻게 생각하나요?
Are you more of an introvert, or an extrovert? What are some examples?	당신은 내향적인가요, 외향적인가요? 몇 가지 예를 들어주세요.
How did religion influence you while growing up?	성장하면서 종교가 당신에게 어떤 영향을 미쳤나요?
In conversation, are you blunt, or tactful?	대화에서 직설적인가요, 아니면 신중한가요?
What have you been proud to own or accomplish?	자랑스러웠던 소유물이나 성취는 무엇인가요?
How do you feel about quitting? When have you quit, or wanted to?	포기에 대해 어떻게 생각합니까? 포기한 적이 있거나 포기하고 싶었던 적이 있습니까?
What's your weakness, your Achilles heel?	당신의 약점, 아킬레스건은 무엇인가요?
Are the rich obligated to help those with less?	부유한 사람들이 덜 가진 사람들을 도와야 할 의무가 있습니까?
Do you meditate, or have another way to quiet your mind?	명상을 하거나 마음을 진정시키는 다른 방법이 있습니까?
If genetic alteration was safe and affordable, would you change anything about yourself?	유전자 변형이 안전하고 저렴하다면 자신에 대해 무엇을 바꾸고 싶습니까?
What lesson did you learn the hard way?	어려운 방법으로 배운 교훈은 무엇입니까?
Do you have any favorite road trip memories?	좋아하는 로드 트립 기억이 있습니까?
What are you responsible for, and what is outside your control?	무엇에 대해 책임이 있으며 무엇이 통제 밖에 있습니까?
What did you do when you were younger, that you would never do now?	어렸을 때는 했지만 지금은 절대 하지 않을 일은 무엇입니까?
What was your favorite thing about school? What do you remember about it?	학교에 대해 가장 좋아했던 것은 무엇입니까? 그에 대해 무엇을 기억합니까?
Other than at home and school, where did you spend lots of time while growing up?	집과 학교 외에 어린 시절 많은 시간을 보낸 곳은 어디입니까?
What do you remember about learning to drive?	운전 배우기에 대해 기억하는 것은 무엇입니까?
Are you a minimalist, or do you enjoy having lots of stuff?	미니멀리스트인가요, 아니면 많은 물건을 가지는 것을 좋아합니까?
What were some of your most prized possessions as a child?	어렸을 때 가장 소중했던 소유물은 무엇입니까?
Is there anyone you consider family, even though you're not blood relatives?	피를 나눈 가족은 아니지만 가족이라고 여기는 사람이 있습니까?
How valuable is your time?	당신의 시간은 얼마나 가치가 있습니까?
When have you been so excited or anxious for something that you couldn't sleep?	무엇인가에 대해 너무 흥분하거나 불안해서 잠을 잘 수 없었던 적이 있습니까?
What purpose does religion serve? Will we always have religion?	종교는 어떤 목적을 수행합니까? 우리는 항상 종교를 가질까요?
What kind of driver are you? Relaxed, anxious, irritable, cautious, etc?	어떤 유형의 운전자입니까? 느긋한, 불안한, 짜증나는, 신중한 등.
How true is the saying "It's not what you know, but who you know"?	아는 것이 아니라 아는 사람이다라는 말이 얼마나 진실합니까?
How well have you kept in touch with old friends?	오래된 친구들과 얼마나 잘 연락을 유지하고 있습니까?
What comes easily to you?	쉽게 할 수 있는 것은 무엇인가요?
It's been said that worry is "a misuse of the imagination". What do you think about worry?	걱정은 "상상력의 오용"이라는 말이 있습니다. 걱정에 대해 어떻게 생각합니까?
How did you meet your closest friend(s)?	가장 가까운 친구와 어떻게 만났나요?
Share a time when someone was surprisingly generous to you.	누군가 당신에게 놀랍도록 관대했던 때를 공유하세요.
What sort of competition do you enjoy?	어떤 종류의 경쟁을 즐깁니까?
Is variety important to you, or are you a creature of habit? What's an example?	다양성이 중요합니까, 아니면 습관의 동물입니까? 예를 들어보세요.
What big change are you happy that you made in your life?	당신의 인생에서 기쁘게 여기는 큰 변화는 무엇입니까?
Are you good at fixing things? Do you enjoy it?	물건을 고치는 데 능숙합니까? 그것을 즐깁니까?
What's the most money you've held in your hand?	손에 쥐어본 돈 중 가장 많은 금액은 얼마입니까?
Have you ever lived alone? Did you enjoy it?	혼자 살아본 적이 있습니까? 그것을 즐겼습니까?
Do you believe in ghosts or other supernatural phenomena? Why?	유령이나 다른 초자연적 현상을 믿습니까? 왜 그런가요?
What was the most fun or exciting time in your life?	당신의 인생에서 가장 재미있고 흥미진진한 시기는 언제였나요?
What does success mean to you?	성공은 무엇을 의미합니까?
Have you experienced an earthquake, hurricane, or other extreme natural event?	지진, 허리케인 또는 다른 극심한 자연 현상을 경험한 적이 있습니까?
How important have pets or other animals been in your life?	물이나 다른 동물들이 당신의 삶에 얼마나 중요했습니까?
Have you ever badly misjudged someone?	누군가를 심하게 오해한 적이 있습니까?
Do you believe in psychic visions, ESP, etc? Have you had any experiences?	심령 비전, ESP 등을 믿습니까? 그런 경험이 있습니까?
Remember a time when you have said or done something awkward or inappropriate.	당신이 어색하거나 부적절한 말을 했던 때를 기억하세요.
Finish the following sentence: I could never date someone who _______.	다음 문장을 완성하세요: 나는 절대 _____ 사람과 데이트할 수 없습니다.
Have you ever had a lucky break, or a case of synchronicity?	행운의 기회나 동시성의 사례가 있었습니까?
Have you ever been chosen as an audience volunteer for a show?	쇼에서 관객 자원 봉사자로 뽑힌 적이 있습니까?
As a child, what did you daydream about?	어렸을 때 무엇을 꿈꿨나요?
What is compassion? Who is compassionate?	자비란 무엇입니까? 누가 자비로운가요?
What's the best financial decision you've made?	가장 좋은 재정적 결정은 무엇이었습니까?
What gives you hope?	무엇이 당신에게 희망을 줍니까?
What do you share openly, and what is best kept private?	공개적으로 공유하는 것과 비공개로 유지하는 것이 무엇인가요?
Do you remember the first time you had the wind knocked out of you?	처음으로 바람을 맞은 것을 기억하나요?
Are you good at having awkward but necessary conversations? Or do you avoid them?	어색하지만 필요한 대화를 잘하나요? 아니면 피하나요?
How do you feel about mistakes and failure?	실수와 실패에 대해 어떻게 생각합니까?
What is one of your favorite places? What makes it special?	가장 좋아하는 장소는 어디인가요? 무엇이 그것을 특별하게 만드나요?
Do you have any strong memories from your first day in a new school, job, city, etc?	새 학교, 직장, 도시 등에서 첫날에 강렬한 기억이 있습니까?
Have you ever been knocked unconscious? What happened?	의식을 잃은 적이 있습니까? 무슨 일이 있었나요?
What is something illegal, that you find morally acceptable?	도덕적으로 받아들일 수 있지만 불법인 것은 무엇입니까?
Who do you admire? Why?	누구를 존경합니까? 왜 존경합니까?
Are you more of a leader or a follower?	지도자형인가요, 추종자형인가요?
How do you feel when you see others succeed?	다른 사람들이 성공하는 것을 볼 때 어떻게 느낍니까?
Do you say things you later regret?	나중에 후회하는 말을 한 적이 있습니까?
Have you ever urgently needed a toilet at the wrong time or place?	잘못된 시간이나 장소에서 급하게 화장실이 필요했던 적이 있습니까?
What do you remember about the neighborhood you grew up in?	어렸을 때 자란 동네에 대해 무엇을 기억합니까?
How much do you care what others think of you? How does it affect your life?	다른 사람들이 당신에 대해 어떻게 생각하는지 얼마나 신경 씁니까? 그것이 당신의 삶에 어떤 영향을 미칩니까?
Remember a time during your childhood when an adult did something kind for you.	어린 시절 성인이 친절하게 대해준 때를 기억하세요.
What's the worst financial decision you've made?	가장 나쁜 재정적 결정은 무엇이었습니까?
How would the world change if lying wasn't possible?	거짓말이 불가능하다면 세상은 어떻게 변할까요?
Imagine you can have any job in the world. What will you choose?	세상에서 어떤 직업이라도 가질 수 있다면 무엇을 선택할까요?
What work did your parents do when you were young? What do you remember about it?	어렸을 때 부모님은 어떤 일을 하셨나요? 그것에 대해 무엇을 기억합니까?
How do you feel about competition?	경쟁에 대해 어떻게 생각합니까?
What are some of your best traits? Some of your worst?	당신의 최고의 성격은 무엇입니까? 최악의 성격은 무엇입니까?
When have you let fear hold you back? Fear of failure, rejection, the unknown...	두려움 때문에 뒷걸음질 친 적이 있습니까? 실패, 거절, 미지의 것에 대한 두려움 등.
Do you remember lying to your parents? If so, how?	부모님에게 거짓말을 한 적이 있습니까? 만약 있다면 어떻게 했나요?
Do you think about your own mortality?	자신의 죽음을 생각합니까?
What sort of comedy do you like? Any examples?	어떤 종류의 코미디를 좋아합니까? 예시가 있나요?
Can you remember an embarrassing moment you're willing to share?	당신이 공유할 수 있는 당황스러운 순간을 기억하세요.
When have you been part of a good team? What do you remember about it?	좋은 팀의 일원이었을 때를 기억하세요. 무엇이 기억에 남나요?
What amount of money makes someone "rich"?	얼마나 많은 돈이 사람을 "부유"하게 만드나요?
Share a past accomplishment of yours that others don't know about.	다른 사람들이 모르는 과거의 성취를 공유하세요.
Do you believe in bad luck, jinxes, curses, etc.?	불운, 징크스, 저주 등을 믿습니까?
What would be a fun or interesting subject to study with a teacher of your choice?	선택한 선생님과 함께 공부하고 싶은 재미있거나 흥미로운 주제는 무엇인가요?
Is it ever ok to lie?	거짓말을 해도 되는 경우가 있나요?
When have you been underestimated?	과소평가받은 적이 있나요?
What building or place was important to you, that doesn't exist now?	당신에게 중요했던 건물이 나 장소가 이제는 존재하지 않습니까?
What is one of the biggest decisions you've made? What if you hadn't made it?	가장 큰 결정 중 하나는 무엇입니까? 그것을 하지 않았다면 어떻게 되었을까요?
What do you think about gossip? How often do you gossip?	가십에 대해 어떻게 생각합니까? 얼마나 자주 가십합니까?
During what activity does time seem to pass without you noticing?	어떤 활동 중 시간이 눈 깜짝할 사이에 지나가는 것을 느낍니까?
Why are some places richer or poorer than others?	어떤 이유로 어떤 장소는 부유하거나 가난합니까?
Do you remember the last time you were on a stage? Have you been on stage often?	무대에 마지막으로 오른 때를 기억합니까? 무대에 자주 오르나요?
Have you attended any sort of reunion? If so, how was it?	어떤 종류의 재회를 참석한 적이 있습니까? 만약 그렇다면 어땠나요?
Would you rather spend time in the city, or in nature? Why?	도시에서 시간을 보내고 싶습니까, 자연에서 시간을 보내고 싶습니까? 왜 그런가요?
How does parenthood affect one's life, positive and negative?	부모가 되는 것이 한 사람의 삶에 어떻게 영향을 미칩니까? 긍정적이든 부정적이든.
How were you different from the other children in your neighborhood or school?	동네나 학교에서 다른 아이들과 어떻게 달랐나요?
How often do you give compliments? How does it make you feel?	얼마나 자주 칭찬을 합니까? 그것이 당신을 어떻게 느끼게 합니까?
How often do you remember your dreams? What sort of dreams do you have?	꿈을 얼마나 자주 기억합니까? 어떤 종류의 꿈을 꾸나요?
Who are great examples of what a family should be? Why?	가족이 어떤 모습이어야 하는지에 대한 훌륭한 예는 누구입니까? 왜 그렇습니까?
In what way do people sometimes misjudge you?	사람들이 때때로 당신을 잘못 판단하는 방식은 무엇입니까?
How do you feel about giving and receiving gifts? Any favorite memories?	선물 주고 받는 것에 대해 어떻게 생각합니까? 특별한 기억이 있나요?
Would you consider cosmetic surgery? What if it was affordable and 100% safe?	성형 수술을 고려하시겠습니까? 만약 저렴하고 100% 안전하다면요?
How much of life depends on decisions and actions, versus luck?	인생의 몇 퍼센트가 결정과 행동에 의존하고, 몇 퍼센트가 운에 의존합니까?
What societal norms do you not take part in?	참여하지 않는 사회적 규범은 무엇입니까?
Do you normally buy new or used? Why?	보통 새것을 삽니까, 아니면 중고를 삽니까? 왜 그런가요?
How important is a college degree? Has this changed over time?	대학 학위가 얼마나 중요합니까? 시간이 지남에 따라 이것이 변했나요?
Can it be funny when someone gets hurt? Why?	누군가가 다칠 때 재미있을 수 있습니까? 왜 그런가요?
What sort of art do you like? Why?	어떤 종류의 예술을 좋아합니까? 왜 그런가요?
Are you a private person, or an open book?	당신은 비밀스러운 사람인가요, 아니면 열려 있는 사람인가요?
Have you changed your mind on an important issue? If so, why?	중요한 문제에 대해 생각이 바뀐 적이 있습니까? 만약 있다면 왜 그런가요?
How is your memory? What sorts of things do you remember or forget?	기억력이 어떻습니까? 어떤 종류의 것들을 기억하거나 잊습니까?
How often are you away from your phone and other devices?	얼마나 자주 휴대폰과 다른 기기에서 떨어져 있습니까?
How judgmental are you?	당신은 얼마나 판단적인가요?
What is one of the best gifts you've ever received?	받았던 최고의 선물 중 하나는 무엇입니까?
What do you enjoy learning about? How do you learn it?	무엇을 배우는 것을 즐기나요? 어떻게 배우나요?
If you moved to another area, what would you miss about your current home?	다른 지역으로 이사한다면 현재 집에서 무엇을 그리워할까요?
Have you ever been a hero, saving someone from injury or death? Has anyone saved you?	영웅이 되어 누군가를 부상이나 죽음에서 구한 적이 있습니까? 누군가가 당신을 구한 적이 있습니까?
Is the world loving, hostile, or indifferent?	세상은 사랑스럽습니까, 적대적입니까, 무관심합니까?
Remember a time you felt nervous before doing something. How did it go?	무언가를 하기 전에 긴장했던 때를 기억하세요. 그것은 어떻게 되었습니까?
What important truth do few people agree with you on?	많은 사람들이 동의하지 않는 중요한 진실은 무엇입니까?
What was a turning point in your life?	당신의 삶의 전환점은 무엇이었습니까?
Is it ever ok to lie to children? If so, when?	아이들에게 거짓말을 해도 되는 경우가 있나요? 만약 있다면 언제인가요?
How do you best learn? Watching, hearing, doing, reading?	어떻게 가장 잘 배우나요? 보기, 듣기, 하기, 읽기?
When you make a mistake that others find funny, are you able to laugh at yourself?	다른 사람들이 재미있다고 생각하는 실수를 했을 때 스스로 웃을 수 있습니까?
What is your most important goal right now?	현재 가장 중요한 목표는 무엇입니까?
How do you greet and say goodbye to your friends & family? A handshake, hug, kiss, etc?	친구와 가족에게 어떻게 인사하고 작별 인사를 하나요? 악수, 포옹, 키스 등.
You just became a billionaire. What will you buy for yourself? And for others?	당신은 갑자기 억만장자가 되었습니다. 자신에게 무엇을 사시겠습니까? 다른 사람들에게는요?
Should people be free to do anything they want, if they're not hurting anyone else?	사람들이 다른 사람에게 해를 끼치지 않는 한 무엇이든 자유롭게 할 수 있어야 합니까?
When has your physical appearance, skin color, nationality, etc. affected how others treated you?	당신의 외모, 피부색, 국적 등이 다른 사람들이 당신을 대하는 방식에 영향을 미친 적이 있습니까?
What social custom would you rather avoid?	피하고 싶은 사회적 관습은 무엇입니까?
What class did you most enjoy in school?	학교에서 가장 즐겼던 수업은 무엇입니까?
What do you remember about your first vehicle?	첫 번째 차량에 대해 무엇을 기억합니까?
Have you ever broken a bone? What happened?	뼈를 부러뜨린 적이 있습니까? 무슨 일이 있었나요?
What different advantages do men and women have in the world?	남성과 여성이 세상에서 갖는 서로 다른 장점은 무엇입니까?
Can you recall an especially awkward family moment?	특히 어색했던 가족 순간을 기억합니까?
Do you remember the time before online shopping? How was life different then?	온라인 쇼핑 이전의 시대를 기억합니까? 그때의 삶은 어땠나요?
Do you have many friends, or a few close friends?	친구가 많습니까, 아니면 몇 명의 가까운 친구가 있습니까?
Do you have siblings? How have they influenced you?	형제자매가 있습니까? 그들이 당신에게 어떤 영향을 미쳤습니까?
Who do you go to for advice?	조언을 구하는 사람은 누구입니까?
Was a particular birthday meaningful for you? Why?	특별한 생일이 있었습니까? 왜 그랬나요?
What makes a good listener? Are you a good listener?	좋은 청취자가 되는 것은 무엇입니까? 당신은 좋은 청취자인가요?
What small moment in your life led to a big change?	작은 순간이 큰 변화를 가져온 때는 무엇입니까?
Have you done much traveling? Would you like to? Why?	여행을 많이 했습니까? 하고 싶습니까? 왜 그런가요?
Imagine you have all the money you will ever need. How will you spend your time?	모든 돈이 충분히 있다고 상상해보세요. 시간을 어떻게 보낼 것인가요?
How important is punctuality? Are you usually on time?	시간 엄수는 얼마나 중요한가요? 당신은 보통 시간을 잘 지키나요?
How often do you cook? Do you enjoy it?	얼마나 자주 요리를 하나요? 요리를 즐기나요?
Who are some of the kindest people you've known?	당신이 알고 있는 가장 친절한 사람들은 누구인가요?
What is one of your greatest achievements? Why did you do it?	당신의 가장 큰 업적 중 하나는 무엇입니까? 왜 그것을 했나요?
Have you been unable to stop laughing at an inappropriate time?	부적절한 상황에서 웃음을 멈출 수 없었던 적이 있나요?
Will humans someday live off Earth?	언젠가 인간이 지구 밖에서 살게 될까요?
When have you overcome your fear? How did you do it? How did it feel?	언제 두려움을 극복했습니까? 어떻게 했습니까? 그때 어떤 느낌이었나요?
What is the future of privacy? Will people value privacy 100 years from now?	프라이버시의 미래는 어떻게 될까요? 100년 후에도 사람들은 프라이버시를 중요하게 여길까요?
How do you deal with difficult emotions? Anger, fear, sadness, etc.	어려운 감정(분노, 두려움, 슬픔 등)을 어떻게 처리합니까?
Who brings out the best in you? How?	당신의 최고의 모습을 이끌어내는 사람은 누구입니까? 어떻게 그렇게 하나요?
Who was a hero of yours while growing up? Why?	어렸을 때 당신의 영웅은 누구였습니까? 왜 그랬나요?
If you knew you would never be caught, which laws would you break?	절대 잡히지 않을 것이라는 것을 알았다면 어떤 법을 어기겠습니까?
When have you been particularly grateful to have access to modern healthcare?	현대 의료 혜택을 받아서 특히 감사했던 적이 있습니까?
What do you do for fun? What do you like about it?	재미를 위해 무엇을 하나요? 무엇이 그것을 좋아하게 만드나요?
What outdoor activity did you enjoy as a child?	어렸을 때 즐겼던 야외 활동은 무엇입니까?
When have you gotten lost? What happened?	길을 잃었던 적이 있나요? 무슨 일이 있었나요?
Who's belief in you increased your belief in yourself?	당신에 대한 믿음이 당신 스스로에 대한 믿음을 증가시킨 사람은 누구인가요?
What does courage mean to you? Who is courageous?	용기는 무엇을 의미하나요? 누가 용감한가요?
Do you think humans will merge with technology? If so, how will it change the world?	인간이 기술과 융합될 것이라고 생각합니까? 만약 그렇다면 세상은 어떻게 변할까요?
How does attitude affect one's life?	태도는 한 사람의 삶에 어떤 영향을 미칩니까?
Do you have a consistent bedtime? Is it important to you?	일관된 취침 시간을 갖고 있습니까? 그것이 당신에게 중요한가요?
Is there a habit you would like to develop? Or one you would like to break?	기르고 싶은 습관이나 버리고 싶은 습관이 있나요?
How important is mental toughness? Are you mentally tough?	정신력은 얼마나 중요한가요? 당신은 정신력이 강한가요?
How was your first date? What do you remember about it?	첫 데이트는 어땠나요? 그것에 대해 무엇을 기억합니까?
Should we be realistic, or follow our dreams? Can we do both?	현실적이어야 하나요, 아니면 꿈을 따라가야 하나요? 둘 다 할 수 있나요?
Do you expect to live a long life? Why, or why not?	오래 살기를 기대합니까? 왜 그렇거나 왜 그렇지 않나요?
How often have you experienced rejection? How do you handle it?	거절을 얼마나 자주 경험했습니까? 어떻게 대처하나요?
What job have you had that others might not know about?	다른 사람들이 모르는 직업을 가진 적이 있습니까?
You can visit any time and place in the past or future. Where will you go?	과거나 미래의 어느 시간과 장소를 방문할 수 있다면 어디로 갈 것인가요?
Have you gotten along well with your teachers, coaches, bosses, etc?	선생님, 코치, 상사 등과 잘 지내셨나요?
Do you speak more than one language? If not, would you like to?	두 개 이상의 언어를 구사합니까? 그렇지 않다면 배우고 싶은 언어가 있나요?
How did you end up in your present or past occupation?	현재의 직업이나 과거의 직업에 어떻게 이르게 되었나요?
In what ways are you similar to your parents? And how are you different?	부모님과 어떻게 비슷하고 어떻게 다른가요?
Are most people trustworthy and reliable? Are you quick to trust people?	대부분의 사람들은 신뢰할 만하고 믿을 만한가요? 당신은 사람을 빠르게 신뢰하나요?
What is legal, but socially unacceptable?	합법적이지만 사회적으로 용납되지 않는 것은 무엇인가요?
Do you often compare yourself to others? Is it helpful or harmful?	자신을 다른 사람과 자주 비교합니까? 그것이 도움이 되나요, 해롭나요?
What's the most fun you can have for $20?	$20로 할 수 있는 가장 재미있는 일은 무엇입니까?
Have you been to a formal dance? What do you remember about it?	정식 무도회에 참석한 적이 있습니까? 그때 무엇이 기억에 남나요?
What is different or interesting about your family?	당신의 가족에 대해 특별하거나 흥미로운 것은 무엇인가요?
How important is the company you keep? How selective are you?	어떤 사람들과 어울리는지가 얼마나 중요한가요? 얼마나 신중하게 선택합니까?
Has online dating been a positive change for society?	온라인 데이팅이 사회에 긍정적인 변화를 가져왔습니까?
What tests your patience, and how do you deal with it?	당신의 인내심을 시험하는 것은 무엇인가요? 어떻게 대처합니까?
You must spend a million dollars on impractical things for yourself. What will you buy?	자신을 위해 실용적이지 않은 것에 백만 달러를 써야 합니다. 무엇을 사겠습니까?
What was the first concert you went to?	첫 번째 콘서트는 무엇이었나요?
How does your mood affect the music you choose?	기분이 음악 선택에 어떻게 영향을 미칩니까?
What failure made you stronger or wiser?	어떤 실패가 당신을 더 강하게 또는 현명하게 만들었습니까?
Would you rather work half as much for your current income, or work your usual hours and double your income?	현재의 수입을 위해 일하는 시간을 절반으로 줄이거나, 현재의 시간 동안 일하고 수입을 두 배로 늘리기를 원합니까?
How do you make big decisions? Do you patiently analyze? Do you "go with your gut"?	큰 결정을 어떻게 내립니까? 신중하게 분석합니까? 직감에 따라 갑니까?
Do you have a favorite book or genre? What do you like about it?	좋아하는 책이나 장르가 있습니까? 무엇을 좋아하나요?
How superstitious are you?	얼마나 미신적인가요?
What accents do you like? If you could choose a new accent for yourself, what would you choose?	어떤 억양을 좋아합니까? 자신에게 새로운 억양을 선택할 수 있다면 무엇을 선택하겠습니까?
Do you enjoy a rainy day? Why?	비 오는 날을 즐깁니까? 왜 그렇습니까?
What is something you expected to use often, but you don't?	자주 사용할 것이라고 예상했지만 사용하지 않는 것은 무엇인가요?
What do you know about your ancestry? Is it important to you?	자신의 조상에 대해 무엇을 알고 있습니까? 그것이 당신에게 중요한가요?
Do you believe life exists outside Earth? Intelligent life?	지구 밖에 생명이 존재한다고 믿습니까? 지적 생명체가 존재한다고 믿습니까?
Do you have any regrets? Is it useful to have regrets?	후회가 있습니까? 후회가 유용하다고 생각합니까?
Do you prefer a night out, or a night in? Has this changed over time?	밤 외출을 선호합니까, 아니면 집에서의 밤을 선호합니까? 시간이 지나면서 이것이 변했나요?
You can have any item once owned by someone famous. What do you choose?	유명인이 소유했던 아이템을 하나 가질 수 있다면 무엇을 선택하겠습니까?
What's the scariest thing you've done?	가장 무서운 일을 한 적이 있습니까?
You must spend a year on a remote island with only one other person. Who will you choose?	외딴 섬에서 다른 사람과 1년을 보내야 합니다. 누구를 선택하겠습니까?
Do you know what you want in life?	삶에서 원하는 것이 무엇인지 알고 있습니까?
What kind of exercise do you enjoy? What do you like about it?	어떤 운동을 즐기나요? 무엇이 그것을 좋아하게 만드나요?
Have you gotten back in touch with someone after a long time apart?	오랫동안 연락이 끊긴 사람과 다시 연락을 주고받은 적이 있습니까?
Did you spend much time alone as a child? What did you enjoy doing by yourself?	어린 시절 혼자 시간을 많이 보냈나요? 혼자 무엇을 즐겼나요?
When has it taken courage to be yourself?	자신이 되기 위해 용기가 필요했던 때가 있습니까?
Have you ever seen an unexplained object in the sky?	하늘에서 설명할 수 없는 물체를 본 적이 있습니까?
What country would you like to visit? Why?	방문하고 싶은 나라는 어디입니까? 왜 그렇습니까?
How do you deal with winning and losing? Are you humble in victory, gracious in defeat?	승리와 패배에 어떻게 대처합니까? 승리할 때 겸손합니까, 패배할 때 관대합니까?
Are you well-organized? How do you do it?	당신은 잘 정리된 사람인가요? 어떻게 그렇게 합니까?
Do you put your faith in religion, science, or both?	종교, 과학, 또는 둘 다에 신뢰를 두고 있습니까?
What's one of the stupidest ways you've gotten hurt?	가장 어리석은 방법으로 다친 적이 있습니까?
What was a favorite activity when you were young? How did it influence you?	어렸을 때 가장 좋아했던 활동은 무엇입니까? 그것이 당신에게 어떤 영향을 미쳤습니까?
What do you remember about your first time drinking alcohol?	첫 술자리 경험에 대해 무엇을 기억합니까?
When have you tried out for something? How did it go?	무언가에 도전한 적이 있습니까? 결과는 어땠습니까?
Which of your personality traits have helped you most in life?	당신의 성격 특성 중 어떤 것이 인생에서 가장 도움이 되었습니까?
When is it morally acceptable to break the law?	법을 어기는 것이 도덕적으로 받아들일 수 있는 경우는 언제입니까?
Did you have an early or significant experience with death? How did you deal with it?	초기나 중요한 죽음 경험이 있었나요? 어떻게 대처했습니까?
What did your parents or other role models teach you about money?	부모님이나 다른 롤 모델이 돈에 대해 가르쳐 준 것은 무엇입니까?
How important is time to relax? Do you get enough?	휴식 시간이 얼마나 중요한가요? 충분히 휴식하고 있습니까?
Do you play a musical instrument? If not, would you like to?	악기를 연주합니까? 그렇지 않다면 배우고 싶은 악기가 있습니까?
When making group decisions, do you speak up, or go along with others?	그룹 의사 결정을 할 때, 의견을 적극적으로 말합니까 아니면 다른 사람들의 의견에 따릅니까?
How important is time with family? How much is appropriate?	가족과의 시간이 얼마나 중요한가요? 얼마나 많은 시간이 적당하다고 생각합니까?
What were the most useful things you learned at school?	학교에서 배운 가장 유용한 것들은 무엇입니까?
How were you influenced by the culture of the area you grew up in?	당신이 자란 지역의 문화가 당신에게 어떻게 영향을 미쳤습니까?
How well do you receive criticism or advice?	비판이나 조언을 얼마나 잘 받아들입니까?
What challenge made you a stronger or wiser person?	당신을 더 강하게 또는 현명하게 만든 도전은 무엇입니까?
Did you ever sneak into an event, building, etc? How was it?	이벤트, 건물 등에 몰래 들어간 적이 있습니까? 그 경험은 어땠습니까?
How has your hometown changed since you were young?	고향이 어렸을 때와 어떻게 변했습니까?
When you were young, what did you dream of later doing or having?	어렸을 때 나중에 하고 싶거나 가지고 싶었던 것을 꿈꾸었습니까?
How have you benefited from science and technology?	과학과 기술로부터 어떤 혜택을 받았습니까?
Do you believe in an afterlife, or reincarnation?	사후세계나 환생을 믿습니까?
You must move to another country for the rest of your life. Which country do you choose, and why?	남은 인생을 다른 나라에서 보내야 한다면 어떤 나라를 선택하겠습니까? 왜 그렇습니까?
Do you keep a journal or a diary? Why, or why not?	일기나 다이어리를 쓰나요? 왜 그렇거나 왜 그렇지 않나요?
What would you do differently if you had a second chance?	두 번째 기회가 있다면 무엇을 다르게 하겠습니까?
Do you have a quick temper, or a "long fuse"?	화를 빨리 내나요, 아니면 참는 편인가요?
Do you live for the moment, or prepare for the future?	현재를 위해 사는 편인가요, 아니면 미래를 위해 준비하는 편인가요?
How do you like to enjoy the outdoors?	야외 활동을 어떻게 즐기나요?
Should children be protected, or allowed to explore and learn on their own?	어린이들을 보호해야 하나요, 아니면 스스로 탐험하고 배우도록 해야 하나요?
Do you talk about politics with your friends and family?	친구나 가족과 정치에 대해 이야기합니까?
What advice would you give yourself at 18 years old?	18살 때 자신에게 어떤 조언을 해주고 싶습니까?
When or where do you have your best ideas?	언제나 어디에서 최고의 아이디어가 떠오르나요?
How do you feel about holidays? Are they joyful, stressful, meaningful?	휴일에 대해 어떻게 생각합니까? 즐겁나요, 스트레스받나요, 의미 있나요?
Are people too easily offended? Are you easily offended?	사람들이 너무 쉽게 기분 상하는가요? 당신은 쉽게 기분이 상하나요?
Do you have obligations you want to end? What else could you do with your time?	끝내고 싶은 의무가 있습니까? 시간을 어떻게 다르게 사용할 수 있을까요?
Will humans ever conquer aging?	인간이 노화를 정복할 수 있을까요?
Are you more of a morning person, or night owl? Has this changed over time?	당신은 아침형 인간인가요, 아니면 야행성인가요? 시간이 지나면서 이것이 변했나요?
What are you looking forward to? Why?	무엇을 기대하고 있습니까? 왜 그렇습니까?
Remember a conversation that significantly impacted on your life.	당신의 삶에 큰 영향을 미친 대화를 기억해 보세요.
Do you like to be the center of attention?	관심의 중심에 있는 것을 좋아합니까?
Do you have a long attention span? Do you get bored easily?	집중력이 긴가요? 쉽게 지루해합니까?
Describe one of your favorite teachers or coaches. What made them outstanding?	가장 좋아하는 선생님이나 코치를 묘사해 주세요. 무엇이 그들을 뛰어나게 만들었습니까?
What might you enjoy doing if you were less self-conscious?	자신을 덜 의식하게 되면 무엇을 즐길 수 있을까요?
When do you feel most alive?	언제 가장 생기 있게 느끼나요?
What's on your "bucket list" of things to do during your life?	인생 동안 하고 싶은 일의 목록이 있습니까?
Do you prefer dogs or cats? Or do you love both?	개를 좋아합니까, 고양이를 좋아합니까? 둘 다 좋아합니까?
Have you ever won an award?	상을 받은 적이 있습니까?
What do you appreciate about the culture you were raised in?	당신이 자란 문화에 대해 무엇을 감사하게 생각합니까?
Do you have a favorite season? What do you like about it?	가장 좋아하는 계절이 있습니까? 무엇을 좋아합니까?
If you could travel the galaxies for the rest of your life, but never return to Earth, would you go?	평생 동안 은하계를 여행할 수 있지만 지구로 돌아올 수 없다고 한다면, 가겠습니까?
Have you ever been in a fight? What happened?	싸움을 해본 적이 있습니까? 무슨 일이 있었나요?
Do you enjoy creating art? If so, what do you like about it?	예술 창작을 즐기십니까? 그렇다면 무엇이 그것을 좋아하게 만듭니까?
Do you tend to know when people are lying?	사람들이 거짓말을 할 때 알 수 있습니까?
When did you feel like you didn't fit in?	어울리지 않는다고 느낀 때는 언제였습니까?
What was your first job? Did you enjoy it?	첫 직장은 무엇이었나요? 그것을 즐겼습니까?
Do you believe in fate or destiny?	운명이나 숙명을 믿습니까?
You can spend a day with anyone from the past or present. Who do you choose, and what will you do?	과거나 현재의 누구와 하루를 보낼 수 있다면 누구를 선택하겠습니까? 무엇을 할 것입니까?
When is it appropriate to stand up to someone? When is it better to just let it go?	누군가에게 맞서야 할 때는 언제입니까? 그냥 넘어가는 것이 더 나을 때는 언제입니까?
What do you now understand about yourself, that you didn't understand in the past?	과거에 이해하지 못했던 자신에 대해 이제 이해하게 된 것은 무엇입니까?
What shopping experience do you remember, that isn't common now?	현재는 일반적이지 않은 쇼핑 경험을 기억하세요.
Have you had any memorable interactions with police, a judge, etc?	경찰, 판사 등과의 기억에 남는 상호작용이 있었습니까?
What's your favorite holiday tradition? Why?	가장 좋아하는 휴일 전통은 무엇입니까? 왜 그렇습니까?
Are video games a waste of time? Why or why not?	비디오 게임은 시간 낭비입니까? 왜 그렇거나 왜 그렇지 않습니까?
Do you remember life before cell phones or smartphones? How were things different?	휴대폰이나 스마트폰 이전의 삶을 기억합니까? 그때는 어떻게 달랐나요?
Can most people be trusted with a secret?	대부분의 사람들은 비밀을 지킬 수 있습니까?
Are there topics that should not be joked about, or is humor always ok?	농담으로 다루지 말아야 할 주제가 있습니까, 아니면 유머는 항상 괜찮습니까?
As a child, did you have a fort, or treehouse, etc?	어렸을 때 요새나 나무 집 등을 가졌습니까?
What details do you remember about your childhood home? What did you like about it?	어린 시절 집에 대한 세부 사항을 기억합니까? 무엇을 좋아했습니까?
Have you known many people with a religion other than your own?	당신의 종교와 다른 종교를 가진 사람들을 많이 알고 있습니까?
When have you felt rich?	부유하다고 느꼈던 때는 언제입니까?
When was the last time you cried? Do you cry in front of others?	마지막으로 울었던 때는 언제입니까? 다른 사람들 앞에서 울었습니까?
If you needed help, who would be there for you?	도움이 필요할 때 누가 당신을 도울 것입니까?
Do you more often regret things you did, or things you didn't do?	당신은 한 일을 더 자주 후회합니까, 하지 않은 일을 더 자주 후회합니까?
Do you enjoy camping? Any favorite memories?	캠핑을 즐기십니까? 좋아하는 기억이 있습니까?
When has time seemed to pass more slowly or quickly for you?	시간이 더 천천히 또는 빠르게 흘렀던 때는 언제입니까?
What animal are you scared of? Any encounters?	어떤 동물이 두렵습니까? 어떤 만남이 있었나요?
Who gave you a compliment that you'll never forget? What did they say?	잊지 못할 칭찬을 해준 사람은 누구입니까? 그들이 무엇을 말했나요?
Do you watch or read the news? Is it important, or a stressful waste of time?	뉴스를 보거나 읽습니까? 그것이 중요합니까, 아니면 스트레스가 많은 시간 낭비입니까?
Who have been your role models? What have you learned from them?	당신의 롤 모델은 누구였습니까? 그들로부터 무엇을 배웠습니까?
Is change scary or exciting? Is it both?	변화가 두렵습니까, 흥미롭습니까? 둘 다인가요?
Would you rather be rich or famous? Why?	부유해지길 원합니까, 유명해지길 원합니까? 왜 그렇습니까?
What was the most fun you've had at work?	일하면서 가장 즐거웠던 때는 언제였나요?
What kind of shopper are you? Quick, stick to the list, browser, impulse buyer?	당신은 어떤 유형의 쇼핑객입니까? 빠르게, 목록에 충실하게, 둘러보기, 충동구매?
Who or what brings out the silly side of your personality?	누가 또는 무엇이 당신의 유머러스한 면을 이끌어냅니까?
Which movie have you watched the most? What do you like about it?	가장 많이 본 영화는 무엇입니까? 왜 그것을 좋아합니까?
Have you performed, spoken, or competed in front of an audience? How was that?	관객 앞에서 공연, 연설, 경연 등을 한 적이 있습니까? 어땠습니까?
Who would you like to spend more time with?	더 많은 시간을 보내고 싶은 사람은 누구입니까?
What about your adult life would impress your childhood self?	당신의 성인 생활에서 어린 시절 자신을 감동시킬 만한 것은 무엇입니까?
Describe your perfect day.	완벽한 하루를 묘사해 보세요.
Do you enjoy buying and selling things? Any interesting stories?	물건을 사고 파는 것을 즐깁니까? 흥미로운 이야기가 있습니까?
Remember a time you felt "butterflies" in your stomach. What does that feeling mean to you?	배 속에서 '나비가 날아다니는' 느낌을 받았던 때를 기억하세요. 그 느낌이 당신에게 무엇을 의미합니까?
How do you feel about being optimistic versus being realistic?	낙관주의와 현실주의에 대해 어떻게 생각하십니까?
Do the years seem to pass more quickly as we grow older? Why?	나이가 들수록 시간이 더 빨리 지나가는 것처럼 느끼나요? 왜 그런가요?
You just received a million dollars to donate to charity. Which causes will you support?	기부를 위해 백만 달러를 받았습니다. 어떤 원인을 지원하시겠습니까?
How has marriage changed over recent generations?	결혼은 최근 세대 동안 어떻게 변했습니까?
As a child, what sort of scary monsters or animals were you worried about?	어렸을 때 어떤 무서운 괴물이나 동물에 대해 걱정했습니까?
Have you ever collected anything? What did you enjoy about it?	무언가를 수집한 적이 있습니까? 무엇을 즐겼습니까?
Do you think about growing old?	나이 드는 것에 대해 생각합니까?
It's been said "Be kind to unkind people, they need it the most." What do you think?	불친절한 사람들에게 친절하게 대해라, 그들은 그것이 가장 필요하다는 말에 대해 어떻게 생각합니까?
Are you usually well-rested? Why, or why not?	보통 충분한 휴식을 취합니까? 왜 그렇거나 왜 그렇지 않습니까?
What do people say you're good at?	사람들이 당신에게 잘한다고 말하는 것은 무엇입니까?
When would friends and family most likely ask you for help?	친구나 가족이 언제 도움을 요청할 가능성이 높습니까?
Have you been told you couldn't do something, and proved that person wrong?	어떤 일을 할 수 없다고 들었을 때 그 말을 반박한 적이 있습니까?
What decision did you make, that your family or friends didn't approve of?	가족이나 친구가 동의하지 않았던 결정을 한 적이 있습니까?
Do you forgive easily? What are you thoughts on forgiveness?	쉽게 용서하나요? 용서에 대한 당신의 생각은 무엇입니까?
Have you ever had a nickname? How did you get it?	별명이 있었습니까? 어떻게 얻게 되었나요?
Imagine you just lost all your money and possessions. What will you do now?	돈과 소유물을 모두 잃었다고 상상해 보세요. 이제 무엇을 할 것입니까?
What are your thoughts on risk? Is it scary, exciting, unavoidable?	위험에 대해 어떻게 생각합니까? 두렵습니까, 흥미롭습니까, 피할 수 없습니까?
Have you ever been financially broke? Do any memories come to mind?	재정적으로 파산한 적이 있습니까? 기억에 남는 것이 있습니까?
As a child, what were your favorite candles?	어렸을 때 가장 좋아했던 양초는 무엇이었나요?
As a child, did you find it easy to fit in?	어렸을 때 쉽게 어울렸나요?
Are you quick to apologize, or is it difficult for you?	사과를 빨리 하나요, 아니면 어려운가요?
What was your favorite job, and why?	가장 좋아했던 직업은 무엇입니까? 왜 그랬습니까?
Do you set goals? If so, how? Care to share a past or current goal?	목표를 설정합니까? 만약 그렇다면 어떻게 하나요? 과거 또는 현재의 목표를 공유하시겠습니까?
Do you give money or time to causes you believe in? Do you have a favorite memory of giving?	믿는 원인에 돈이나 시간을 기부합니까? 기부에 대한 좋아하는 기억이 있습니까?
Have you bought or sold things on the black market? What and why?	암시장에서 물건을 사고판 적이 있습니까? 무엇이고 왜 그랬습니까?
Which movie characters inspired you?	영화 캐릭터 중 누구에게 영감을 받았습니까?
What was the most difficult time in your life? What did it teach you?	인생에서 가장 어려운 시기는 언제였나요? 그것이 당신에게 무엇을 가르쳤습니까?
If you could instill one virtue or value in the next generation, what would you choose?	다음 세대에게 한 가지 덕목이나 가치를 심어줄 수 있다면 무엇을 선택하겠습니까?
What is a soul?	영혼이란 무엇입니까?
How important is money?	돈은 얼마나 중요한가요?
What are you good at, and how did you learn? Was it talent, practice, hard work?	무엇을 잘하고 어떻게 배웠습니까? 그것이 재능인가요, 연습인가요, 노력인가요?
Have you had a memorable experience using a drug, legal or otherwise?	합법적이든 아니든 약물 사용에 대한 기억에 남는 경험이 있습니까?
Do you have any favorite myths or legends?	가장 좋아하는 신화나 전설이 있습니까?
Can you remember a time you pretended to be sober?	술에 취한 척했던 때를 기억하세요.
Have you ever won a drawing, raffle, lottery, etc? What did you win?	추첨, 복권 등을 당첨된 적이 있습니까? 무엇을 당첨되었나요?
Are you a good judge of character?	사람을 잘 판단하나요?
Are you a planner, or prefer to be spontaneous?	계획을 세우는 편인가요, 아니면 즉흥적인 것을 선호하나요?
Who took care of you when you were sick or injured? What do you remember about that time?	아프거나 다쳤을 때 누가 돌봐 주었나요? 그때의 기억은 무엇입니까?
Have you ever been arrested? If so, what was it like?	체포된 적이 있습니까? 만약 그렇다면 어땠습니까?
What can be frustrating, but you love it anyway?	좌절감을 주지만 여전히 사랑하는 것은 무엇입니까?
Have you ever felt like you were outside your body?	몸 밖으로 나간 것처럼 느낀 적이 있습니까?
You have been granted one new skill or ability. What will you choose?	새로운 기술이나 능력을 하나 부여받았습니다. 무엇을 선택하시겠습니까?
What do you procrastinate?	미루는 일이 무엇입니까?
What gives you joy?	무엇이 당신에게 기쁨을 줍니까?
You just learned you have five years left to live. What will you do?	5년 후에 죽는다는 소식을 들었습니다. 무엇을 하겠습니까?
Imagine you can create or change any one law. What will you do?	어떤 법을 만들거나 변경할 수 있다면 무엇을 하겠습니까?
What is one of your earliest memories?	가장 어린 시절의 기억은 무엇입니까?
Are humans creative enough to solve our biggest challenges?	인간은 우리 가장 큰 도전을 해결할 만큼 창의적인가요?
You have one month to travel anywhere, all expenses paid. Where will you go, what will you do?	모든 비용이 지불된 상태로 어디든지 한 달 동안 여행할 수 있습니다. 어디로 갈 것이며 무엇을 할 것입니까?
How important is personal appearance; dress, hygiene, etc?	개인 외모(옷차림, 위생 등)는 얼마나 중요한가요?
How did you meet your spouse or significant other?	배우자나 중요한 다른 사람과 어떻게 만났습니까?
How would you like people to remember you?	사람들이 당신을 어떻게 기억하기를 원합니까?
What is fear? Is it helpful, limiting, both?	두려움이란 무엇입니까? 그것이 도움이 됩니까, 제한적입니까, 둘 다인가요?
What food reminds you of home? Why?	올리게 하는 음식은 무엇입니까? 왜 그렇습니까?
Are you forgetful, or do you tend to remember details like names, dates, etc?	건망증이 있습니까, 아니면 이름, 날짜 등 세부 사항을 잘 기억합니까?
Remember a time you or someone else laughed uncontrollably.	당신이나 다른 사람이 통제할 수 없을 정도로 웃었던 때를 기억하세요.
Remember an excellent piece of advice you received. How has it helped you?	받은 훌륭한 조언을 기억하세요. 그것이 어떻게 도움이 되었습니까?
Do you follow fads in dress, language, culture, etc?	옷차림, 언어, 문화 등에서 유행을 따릅니까?
What work or activity has been particularly fun or meaningful for you?	특히 재미있거나 의미 있는 일은 무엇입니까?
Do you remember your first experience with a new technology?	새로운 기술과의 첫 경험을 기억합니까?
When you were a child, what was something you dreamed of owning?	어렸을 때 소유하고 싶었던 것을 꿈꾸었습니까?
Did you enjoy your school days? Were you a good student?	학교 생활을 즐겼습니까? 좋은 학생이었습니까?
Do you consider yourself open-minded?	자신을 개방적인 사람으로 생각합니까?
What makes a good friend? Who is an example?	좋은 친구가 되기 위해 필요한 것은 무엇입니까? 좋은 친구의 예는 누구입니까?
How important is imagination? How has it influenced your life?	상상력이 얼마나 중요한가요? 그것이 당신의 삶에 어떤 영향을 미쳤습니까?
What do you find calming?	무엇이 당신을 진정시킵니까?
What activity has helped you meet people and make friends?	사람들을 만나고 친구를 사귀는 데 도움이 된 활동은 무엇입니까?
As a child, what were some of your favorite stories or fairy tales?	어렸을 때 좋아했던 이야기나 동화는 무엇입니까?
How often do you drink caffeine? Do you rely on it?	얼마나 자주 카페인을 섭취합니까? 그것에 의존합니까?
What was a favorite activity of yours while growing up? How did it shape you?	어렸을 때 가장 좋아했던 활동은 무엇입니까? 그것이 당신을 어떻게 형성했습니까?
When does time seem to pass more slowly or quickly for you?	시간이 더 천천히 또는 더 빨리 흐르는 것처럼 느낄 때는 언제입니까?
Do you hold grudges? If so, is it useful or destructive?	원한을 품고 있습니까? 그렇다면 그것이 유용합니까, 파괴적입니까?
Do you have a favorite quote or mantra? Why do you like it?	가장 좋아하는 인용구나 만트라는 무엇입니까? 왜 그것을 좋아합니까?
How often do you lose things? Have you ever lost something important?	얼마나 자주 물건을 잃습니까? 중요한 것을 잃어버린 적이 있습니까?
What do you daydream about?	무엇을 상상합니까?
What science fiction technology would you love to use?	사용해보고 싶은 과학 소설 기술은 무엇입니까?
Which book or author has influenced your life, and how?	어떤 책이나 작가가 당신의 삶에 영향을 미쳤습니까? 어떻게 그랬습니까?
If you could change something about your country's culture, what would you change?	당신의 나라의 문화에 대해 무엇을 바꾸고 싶습니까?
When your heart and your mind differ on a decision, which do you follow?	마음과 머리가 결정에서 다를 때, 어느 쪽을 따르나요?
With whom can you really be yourself?	당신이 정말로 자신일 수 있는 사람은 누구인가요?
When did you want to give someone advice or information, but decided not to?	누군가에게 조언이나 정보를 주고 싶었지만 하지 않기로 한 적이 있나요?
How important is self-esteem? How can it be improved?	자존감은 얼마나 중요한가요? 자존감을 어떻게 높일 수 있을까요?
Have you ever been on TV, radio, in the newspaper, etc?	TV, 라디오, 신문 등 매체에 출연한 적이 있나요?
What advantages or good fortune have you had in life?	삶에서 어떤 이점이나 행운을 가졌나요?
What's a challenge you're facing, or something you'd like to change in your life?	당신이 직면하고 있는 도전이나 삶에서 바꾸고 싶은 것은 무엇인가요?
How well do different generations understand each other?	다른 세대들이 서로를 얼마나 잘 이해하나요?
Is it difficult to admit when you're wrong, or to say "I don't know"?	당신은 잘못을 인정하거나 "모르겠다"라고 말하기 어려운가요?
Do you have any old-fashioned beliefs or values?	옛날식 신념이나 가치를 가지고 있나요?
What's a dream or goal that you've had for a long time?	오랫동안 가지고 있었던 꿈이나 목표가 있나요?
Are you good at negotiating? Do you enjoy it?	협상에 능숙한가요? 협상을 즐기나요?
What website, app or game can you get lost in for hours?	몇 시간 동안 빠져들 수 있는 웹사이트, 앱 또는 게임이 있나요?
Who are you grateful to? Why?	누구에게 감사한가요? 이유는 무엇인가요?
With so much available to learn online, what value do schools offer?	온라인에서 배울 수 있는 것이 많아진 이 시대에 학교는 어떤 가치를 제공하나요?
How do you feel about sharing a bed?	침대를 공유하는 것에 대해 어떻게 생각하나요?
Is boredom ok, or is it to be avoided? How often are you bored?	지루함은 괜찮은가요, 아니면 피해야 할 것인가요? 얼마나 자주 지루함을 느끼나요?
What do you remember about a childhood "crush". How did you show your feelings?	어린 시절의 "짝사랑"에 대해 기억나는 것은 무엇인가요? 어떻게 감정을 표현했나요?
How has parenting changed in recent generations?	최근 세대에서 육아가 어떻게 변했나요?
You must choose one nation to rule the world. Which one will you choose? Why?	하나의 국가를 선택해 세계를 통치해야 한다면, 어느 국가를 선택할 것인가요? 이유는 무엇인가요?
How important is keeping your word?	약속을 지키는 것은 얼마나 중요한가요?
What will be the biggest changes in our world over the next 100 years?	앞으로 100년 동안 우리 세계에서 가장 큰 변화는 무엇일까요?
Have you ever pretended to lose other people, just to be alone?	다른 사람들을 잃어버린 척 하고 혼자 있고 싶었던 적이 있나요?
Have you had a recurring dream? What does it mean?	반복해서 꾸는 꿈이 있나요? 그 꿈은 무엇을 의미하나요?
You just learned that you can perform miracles. What will you do?	기적을 행할 수 있다는 것을 알게 되었다면 무엇을 하겠습니까?
What seems normal where you live, but would be unusual in many places?	당신이 사는 곳에서는 정상적이지만 많은 곳에서 비정상적으로 보일 만한 것은 무엇인가요?
If you could be any kind of famous entertainer, athlete, or performer, what would you do?	만약 당신이 유명한 연예인, 운동선수 또는 공연자가 될 수 있다면, 어떤 일을 하고 싶나요?
The most recent wedding I attended?	가장 최근에 참석한 결혼식은?,
Is my house clean?	내가 사는 집은 깔끔한가?,
Do you believe in God? What is the evidence?	신이 존재한다고 믿는가? 그 증거는?,
The last online video I watched?	마지막으로 본 온라인 영상은?,
What is the newest piece of clothing I wore today?	오늘 입은 옷 중에서 가장 새것은?,
Who am I jealous of?	질투 나는 사람은?,
What confuses me is ___________.	나를 혼동하게 만드는 것은 ___________다.,
My last love was ___________.	나의 마지막 사랑은 ___________다.,
Do I have any new family members recently?	최근에 새로 생긴 가족이 있다면?,
What snacks have I been eating frequently lately?	요즘 자주 먹는 군것질거리는?,
Do I have a favorite website?	즐겨 찾는 인터넷 사이트가 있다면?,
Which direction is my life heading?	내 인생은 어느 길로 나아가고 있는가?,
Write a quote of the day.	오늘의 명언 한마디를 적어보자.,
The most interesting thing that happened today was ___________.	오늘 재미있었던 일은 ___________다.,
How hungry am I currently?	현재 얼마나 배가 고픈가?,
The worst movie I've seen?	내가 본 최악의 영화는?,
A question that makes me anxious and uneasy is?	나를 불안하고 초조하게 만드는 질문은?,
Have I made any new friends?	새로 사귄 친구가 있는가?,
Am I satisfied with my choices today?	오늘 내린 선택들에 만족하는가?,
What is the longest time I've gone without washing my hair?	머리를 감지 않고 버틴 최장 기론은?,
A word I use too often is?	내가 지나치게 자주 사용하는 단어는?,
How long does my commute take?	출퇴근에 걸리는 시간은?,
If I could change my name, what would I want it to be?	이름을 바꿀 수 있다면 무엇으로 하고 싶은가?,
Have I learned any new words recently?	새롭게 알게 된 단어가 있다면?,
Who was the most recent missed call from?	가장 최근에 부재중 전화를 건 사람은?,
Do I prefer dogs or cats?	강아지와 고양이 중에 기르고 싶은 동물은?,
Camping vs. hotel stay?	캠핑 vs. 호텔 숙박?,
What didn't I do today?	오늘 하지 못한 일은 무엇인가?,
Have I held a baby recently?	최근에 아기를 안아본 적이 있는가?,
Today I made ___________.	오늘 ___________을(를) 만들었다.,
Who is my hero?	나의 영웅은 누구인가?,
A boring conversation topic is?	지루하게 느껴지는 대화 주제는?,
Do I leave work on time?	제시간에 퇴근하는가?,
The most attractive voice to me is?	가장 매력적이라고 생각하는 목소리는?,
Is there a day I would like to designate as a national holiday?	국경일로 정하고 싶은 날이 있다면?,
Have I made an impulse purchase recently?	최근에 한 충동구매가 있다면?,
How did I wake up this morning?	오늘 아침 기상은 ___________했다.,
Rate my focus level from 0 to 10.	나의 집중력 지수를 0~10으로 나타내보자.,
When was the last time I accessed social media?	마지막으로 SNS에 접속한 때는?,
What do I need to finish today?	오늘 당장 끝마쳐야 하는 일은?,
What am I currently working hard on?	현재 노력하고 있는 일은?,
What is my favorite dining-out menu?	가장 좋아하는 외식 메뉴는?,
Who do I want at my funeral?	나의 장례식에 부르고 싶은 사람을 적어보자.,
How much water did I drink today?	오늘 물을 얼마나 마셨는가?,
Describe my family in three words.	가족을 세 단어로 표현한다면?,
Who is my current rival?	현재 나의 라이벌은 누구인가?,
Do I want to stay comfortable in reality or seek exciting challenges?	현실에 안주하고 싶은가,흥분되는 도전을 원하는가?
Rate my current happiness from 1 to 10.	현재 느끼는 행복을 1~10으로 표현한다면?,
Today I got ___________.	오늘 ___________을(를) 얻었다.,
Who do I think is the most attractive person in the world?	이 세상에서 가장 매력적이라고 생각하는 사람은?,
The most recent act of forgiveness I experienced?	가장 최근에 관용을 베푼 경험은?,
Lack vs. excess?	모자람 vs. 과함?,
What do I think about while sitting on the toilet?	변기에 앉아서 무슨 생각을 하는가?,
The longest phone call memory?	가장 오래 통화해본 기억은?,
Is there any food I must eat for my health?	건강을 위해 꼭 챙겨먹는 음식이 있다면?,
What do I always buy at the supermarket?	마트에 가서 꼭 사는 물건은?,
Create an acrostic poem for Christmas.	크리스마스로 오행시를 지어보자.,
Rate how spontaneously I acted today from 1 to 10.	오늘 얼마나 즉흥적으로 행동했는지 1~10으로 나타낸다면?,
If I lost something recently, what was it?	가장 최근에 잃어버린 물건이 있다면?,
What was the most embarrassing item on my recent credit card bill?	최근 신용카드 결제 내역에서 가장 당혹스러운 항목은?,
Where do I live?	어디에 사는가?,
What political issue am I interested in these days?	요즘 관심 있는 정치적 이슈는?,
What is the craziest thing I've done for love?	사랑을 위해 저지른 가장 정신 나간 짓은?,
Who made me angry most recently?	가장 최근에 나를 화나게 만든 사람은 누구인가?,
What's in my fridge?	냉장고에 뭐가 들어 있는가?,
How many stamps are in my passport?	여권에 스탬프가 몇 개나 찍혀 있는가?,
If I had to choose between long hair and short hair, which one?	긴 머리와 짧은 머리 중에 하나를 고르라면?,
What is the most valuable item I own?	내가 가진 가장 값나가는 물건은?,
What was my most recent credit card purchase?	가장 최근에 신용카드로 구입한 것은?,
What is my biggest current expense?	현재 가장 큰 지출을 차지하는 부분은?,
What was the best thing that happened today?	오늘 가장 좋았던 일은?,
What are my long winter night thoughts?	긴 겨울밤,오랫동안 잠겨 있는 생각은?
Am I living in the moment?	지금 이 순간을 살고 있는가?,
What song is stuck in my head?	머릿속에서 계속 맴도는 노래는?,
When my dreams come true, who do I want by my side?	꿈이 이루어지는 순간,누가 내 옆에 있었으면 좋겠는가?
Do I need to be persuaded?	설득이 필요한가?,
What was the most productive thing I did today?	오늘 가장 생산적이었던 일은 무엇인가?,
What am I constantly missing?	자꾸만 놓치고 있는 것은?,
A phrase I often quote is?	평소 자주 인용하는 문장은?,
When will I be able to publish a book under my name?	언제쯤 내 이름으로 된 책 한 권을 펴낼 수 있을까?,
What is my computer wallpaper?	컴퓨터 바탕화면은 무엇인가?,
If my past year was made into a movie, what would the title be?	나의 지난 한 해를 영화로 만든다면 제목은?,
What was just my misconception?	나만의 착각에 불과했던 것은?,
What feeling do I get when I hear the word 'independence'?	독립이라는 단어를 들으면 어떤 느낌이 드는가?,
What will I look like at thirty?	나의 서른은 어떤 모습일까?,
Is there something I hear so often it's tiresome?	귀가 닳도록 듣고 있는 말이 있다면?,
Am I in love right now?	지금 사랑하고 있는가?,
Where would I like to live for about a month?	한 달쯤 살아보고 싶은 곳은?,
Do I have a friend like Damien?	친구들 중에 데미안이 있는가?,
What event ended happily?	해피엔딩으로 막을 내린 사건은?,
Describe my best friend in three words.	나의 베스트 프렌드를 세 단어로 표현해보자.,
Is there another self living inside me? Introduce it.	내 안에,또 다른 내가 살고 있는가? 소개해보라.
What is my current profile picture?	현재 프로필 사진은 무엇인가?,
How often do I eat at the student cafeteria?	학생 식당에 얼마나 자주 가는가?,
Which class seems the most difficult this new semester?	새 학기에 가장 힘들 것 같은 수업은?,
Where am I right now? Why am I there?	지금 어디에 있는가? 왜 거기에 있는가?,
Am I loved?	사랑받고 있는가?,
Express today in a short poem.	오늘 하루를 짧은 시로 표현해보자.,
Who has found out about my feelings?	누구에게 마음을 들켰는가?,
What am I thinking right now?	지금 무슨 생각을 하는가?,
Who is the new person I am curious about?	호기심이 가는 새로운 사람은 누구인가?,
What is the sweetest temptation?	가장 달콤한 유혹은?,
Who is the most ahead-of-the-curve senior?	가장 앞서가는 선배는 누구인가?,
Where is my first job likely to be?	내 인생의 첫 직장은 어디일 것 같은가?,
What am I thirsty for?	나는 무엇에 목이 마른가?,
What victory have I savored?	만끽했던 승리는?,
Will I still be here next year?	내년에도 나는 여기에 있을까?,
What is my most challenging task right now?	현재 가장 고전하고 있는 과제는 무엇인가?,
Who accomplished something no one expected?	누구도 예상치 못한 일을 성공시킨 사람은?,
What is the current hot topic?	지금 장안의 화제는 무엇인가?,
What app do I use the most?	가장 즐겨 쓰는 앱(app)은 무엇인가?,
Do I have any idea for a patent?	무엇이든 좋다. 특허를 내고 싶은 아이디어가 있는가?,
Do I have an important exam or interview soon? Am I prepared?	중요한 시험이나 인터뷰가 곧 있는가? 준비되었는가?,
What is expected to be fiercely competitive?	치열한 경쟁이 예상되는 것은?,
When was the last time I danced?	가장 마지막으로 춤을 춘 것은 언제인가?,
What is the top book on my library checkout list?	도서관 대출 1순위 책은 무엇인가?,
What subject needs more research?	좀 더 연구해야 할 대상은?,
What is the most interesting success story?	가장 흥미로웠던 성공 스토리는?,
Everyone becomes a revolutionary in their twenties. Am I like that?	20대에는 누구나 혁명가가 된다. 나도 그런가?,
How old do I think I will live to be? Why?	몇 살까지 살 것 같은가? 그 이유는?,
What is my biggest flaw?	나의 가장 큰 단점은 무엇인가?,
What record have I broken?	최고치를 경신한 기록은?,
What was love at first sight?	첫눈에 반했던 것은?,
Who is living the hardest?	가장 열심히 살고 있는 사람은?,
Is there someone I absolutely must meet?	기어코 만나야 하는 사람이 있는가?,
What was I thinking on my way to the lecture hall most recently?	가장 최근에 강의실에 가면서 무슨 생각을 했는가?,
Where do I study?	어디에서 공부하는가?,
What did I do last night?	어젯밤에 뭘 했는가?,
Who is always lucky? How about me?	언제나 운이 따르는 사람은 누구인가? 나는 어떤가?,
Is there something making me anxious right now?	현재 나를 불안하게 하는 것이 있는가?,
When was the last time I saw the sunset over the sea?	마지막으로 해 지는 바다를 본 건 언제인가?,
What was the most expensive thing I bought in the past three months?	지난 3개월 동안 구입한 것 중에 가장 비싼 물건은?,
Who did I spend the most time with today?	오늘 가장 많은 시간을 함께한 사람은 누구인가?,
Write down all the names of people I thought about today.	오늘 떠올린 사람들의 이름을 전부 적어보자.,
Who has noticeably changed since the new year began?	새해 들어 눈에 띄게 달라진 사람은?,
Who do I call when I'm sad?	슬플 때 누구에게 전화하는가?,
What was the most recent note I wrote by hand about?	가장 최근에 직접 손으로 쓴 메모의 내용은?,
Do I need an entrepreneurial spirit or an artisan spirit right now? If neither, then what kind of spirit?	내게 지금 필요한 것은 기업가정신인가,장인정신인가? 둘 다 아니라면 어떤 정신?
Is there still someone I feel uncomfortable and awkward with? Why?	여전히 불편하고 어색한 사람은? 그 이유는?,
When was the presentation I received applause for?	박수를 받은 프레젠테이션은?,
Have I found the truth?	진리를 찾았는가?,
What has been proven to be false?	거짓으로 판명된 것은?,
What is something or someone I deeply empathize with?	격하게 공감이 가는 일이나 사람은?,
Which friend could I never accept as a roommate?	절대 룸메이트로 받아들일 수 없을 것 같은 친구는?,
Who are the three people having the most significant impact on me this year?	올해 내게 강력한 영향력을 끼치고 있는 세 사람은?,
What type of gathering do I attend the most?	어떤 모임에 가장 많이 참석하고 있는가?,
What's in my backpack right now?	지금 내 백팩에는 무엇이 들어 있는가?,
Is my writing skill improving?	글쓰기 실력은 점점 향상되고 있는가?,
Who was the most impressive person I met on the bus or subway?	버스나 지하철에서 만난 가장 인상적이었던 사람은?,
What is my strongest one-liner for my resume?	나의 가장 강력한 자기소개서 한 줄은?,
What documentary would I recommend to my friends?	친구들에게 추천해주고 싶은 다큐멘터리는?,
When did I make a significant presence felt?	언제 미친 존재감을 드러냈는가?,
What is something I did secretly recently?	최근에 남몰래 한 일은?,
Have I ever blacked out from drinking? How did I feel?	만취해 필름이 끊긴 적이 있는가? 기분이 어땠는가?,
What has ignited my passion?	내 열정에 불을 당겨준 것은?,
What kind of talent does the world need?	세상은 어떤 인재를 원할까?,
On a scale of 1 to 10, where does my financial knowledge fall?	나의 금융지식 수준을 1~10단계로 나눌 때,어느 단계에 있는가?
Should I focus on one thing intensely?	한 우물을 파야 할까?,
What was too good for me?	내게 너무 과분했던 것은?,
What should I fight to obtain?	맞서 싸워 얻어내야 할 것은?,
Have I ever felt like I hit a wall?	벽에 부딪친 느낌이 들었던 적은?,
Do I have an unsent letter?	부치지 못한 편지가 있는가?,
What is my hairstyle?	나의 헤어스타일은?,
Have I ever attended a protest?	시위에 참석한 적 있는가?,
Who is my favorite philosopher?	가장 마음에 드는 철학자는?,
Am I a morning person or a night person?	아침형 인간인가,저녁형 인간인가?
What is my mission?	나의 미션은 무엇인가?,
Is there a non-profit organization I want to work hard for?	열심히 일해보고 싶은 비영리조직이 있다면?,
Is there someone I never reconciled with? Will it be like that forever?	끝내 화해하지 못한 사람은? 영원히 그럴 것 같은가?,
If I have a bad hobby, what is it?	나의 악취미가 있다면?,
What is one thing I would ask a fortune teller?	용한 점쟁이를 만난다면 꼭 물어보고 싶은 한 가지는?,
Should I change my strategy?	전략을 바꿔야 할까?,
When was the last time I wore formal attire?	정장을 차려 입은 적은 언제인가?,
What currently gives me pleasure?	요즘 내게 쾌감을 주는 것은?,
What global trend might influence my future?	내 미래에 영향을 끼칠 것 같은 글로벌 트렌드는?,
What is continuing well?	좋은 흐름을 이어가고 있는 것은?,
What was the most regrettable moment?	가장 아쉬웠던 순간은?,
Where is my first love now, and what are they doing?	첫사랑은 지금 어디서 무엇을 하고 있을까?,
What was the best thing that happened last summer?	작년 여름에 있었던 가장 멋진 일은?,
What is the most ridiculous trend right now?	현재 가장 말도 안 되는 유행은?,
What is the most verified fact?	확실하게 검증된 것은 무엇인가?,
What do I regret discarding?	버리고 나서 후회한 것은?,
Who is the most mysterious person?	가장 미스터리한 사람은?,
What did I overdo this week?	이번 주에 너무 무리했던 일은?,
What are my current spiraling thoughts?	요즘 꼬리에 꼬리를 무는 생각은?,
Have I ever felt threatened?	위협감을 느낀 적이 있었는가?,
What food stimulates my appetite?	입맛을 북돋는 음식은?,
Did the long-awaited message arrive?	오매불망 기다렸던 메시지는 도착했는가?,
What would I name my dream guesthouse?	내가 꿈꾸는 게스트하우스의 이름을 지어보자.,
What was the best twist?	최고의 반전은 무엇이었나?,
Is there a love story around me worthy of a novel?	소설로 펴내도 될 주변의 러브 스토리가 있다면?,
What was the most embarrassing thing this month?	이번 달에 있었던 가장 당혹스러운 일은?,
Why are tears salty?	눈물은 왜 짤까?,
When was money really wasted?	돈이 정말 아까웠던 적은?,
How do I live with my enemies?	적과 함께 살아가는 나만의 방법은?,
What has the best value for money?	가성비 만점인 것은?,
How often do I eat ramen in a week on average?	일주일에 라면을 평균 몇 번 먹는가?,
Is there something I've never told anyone?	(아직) 아무한테도 말하지 않은 것이 있다면?,
Does my life emphasize democratic procedures?	나의 삶은 민주적 절차를 중시하는가?,
Do I have to roll the dice for something?	주사위를 던져야 할 일이 있다면?,
What extreme sport do I want to try?	도전해보고 싶은 익스트림 스포츠는?,
Did I start the day with a positive vibe?	오늘 하루,쾌조의 스타트를 끊었는가?
What book have I read more than twice? Why?	두 번 이상 읽은 책은 무엇인가? 그 이유는?,
Is there something or someone that significantly helps me in my field of study?	내 전공분야에 큰 도움을 주는 것이나 사람이 있다면?,
Where do I mainly get useful information?	유용한 정보를 주로 어디에서 얻는가?,
When has forgetfulness caused me a problem?	건망증 때문에 난감했던 적은?,
What does rain make me think of?	비가 오면 생각나는 것은?,
How often do I eat or drink alone in a week?	일주일에 몇 번 혼자서 밥을 먹거나 술을 마시는가?,
Have I ever applied for something or entered a contest?	어떤 일에 응모하거나 지원해본 경험은?,
Is there something my parents would worry about if they knew?	부모님이 아시면 걱정하실 일이 있는가?,
If I had the chance to give a lecture at my alma mater, what would the topic be?	모교에서 강연을 할 기회가 있다면,그 주제는?
If I could be anyone for 30 minutes, who would I choose?	30분 동안 누구든 될 수 있다면,누가 되고 싶은가?
What is the most brilliant idea I've had recently?	최근에 떠올린 가장 기발한 생각은?,
Who spent the most successful gap year?	휴학기간을 가장 성공적으로 보낸 사람은 누구인가?,
What have I made recently?	최근에 직접 만든 것은 무엇인가?,
Is there something to celebrate?	뭔가 축하할 일이 있는가?,
Where is the coolest place?	가장 시원한 곳은 어디인가?,
What is the biggest problem with the older generation?	기성세대의 가장 큰 문제점은 뭘까?,
Why did I go to the hospital most recently?	가장 최근에 병원에 다녀온 이유는?,
What was a moment that made me tear up?	울컥했던 순간은?,
What is something I can never forgive?	절대 용서할 수 없는 것은?,
What has left me puzzled?	나를 미궁에 빠뜨린 것은?,
What was the most surprising thing that happened on a trip?	여행지에서 생긴 가장 놀라운 일은?,
What certification do I really want to obtain?	꼭 따고 싶은 자격증이 있다면?,
What can I not live without?	나에게 없으면 안 되는 것은 무엇인가?,
What have I recently given up?	최근에 끊은 것은?,
Are my promises and commitments being kept?	약속과 다짐들은 잘 지켜지고 있는가?,
Describe this year in one sentence so far.	지금까지의 올 한해에 대해 한 문장으로 표현해보자.,
Who is the friend farthest away from me right now?	지금 가장 멀리 있는 친구는 누구인가?,
What was the silver lining in a bad situation?	전화위복이 된 일은?,
What has changed the most since this time last year?	작년 이맘때보다 가장 많이 바뀐 것은 무엇인가?,
What rule has proven to be accurate recently?	최근에 딱 들어맞은 법칙은 무엇인가?,
What made my heart race this summer?	올 여름,심장이 쫄깃해졌던 일은?
Who is the quiet but strong friend?	소리 없이 강한 친구는?,
When was the last time I took a flight?	가장 최근에 비행기를 탄 적은 언제인가?,
What is something I need to take the lead on?	선두로 치고 올라가야 하는 일은?,
Describe my current state of mind in five words.	현재 내 마음 상태를 다섯 단어로 나타내보자.,
What art piece left me spellbound?	넋을 잃고 바라본 예술작품은?,
What was a near gamble?	도박이나 다름없었던 일은?,
What is a letter or email I sent with courage?	용기를 내어 보낸 메일이나 편지는?,
What is my current bank balance?	오늘 기준으로 통장 잔액이 얼마인가?,
What should be corrected in history?	역사에서 바로 잡아야 할 것이 있다면?,
What has been my best negotiation so far?	지금껏 최고의 협상은 무엇이었나?,
Who do I wish would understand me?	내 마음을 알아주었으면 하는 사람은?,
What should be recorded?	기록으로 남겨야 할 일은?,
What is the significance of a circled date on my calendar?	달력에 동그라미 쳐진 날의 의미는?,
What was the most recent thing I booked?	가장 최근에 예약한 것은?,
Why am I special?	내가 특별한 이유는 무엇인가?,
What new interest did a friend spark in me?	친구 때문에 새롭게 생긴 흥밋거리는?,
Where have I visited the most in the past month?	최근 한 달 동안 가장 자주 방문한 곳은?,
Has life become smarter?	삶이 더 스마트해진 것 같은가?,
What have I bought but never used?	사놓고 아직 한 번도 안 쓴 것이 있다면?,
What mountain or trekking course do I want to complete?	종주해보고 싶은 산이나 트레킹 코스는?,
What have I recently restarted?	최근에 다시 시작한 것은?,
Who is the wisest person I know?	가장 지혜로운 사람은 누구인가?,
What must I honestly admit?	솔직하게 인정해야 하는 것은?,
What opportunity is too good to miss?	놓치기엔 정말 아까운 기회는?,
What do I keep writing over and over?	마르고 닮도록 쓰고 있는 것은?,
What are my most frequently searched keywords?	요즘 가장 많이 검색하는 키워드는?,
Have I ever stayed up all night?	뜬눈으로 밤을 새운 적이 있는가?,
What is my secret project?	비밀리에 진행하고 있는 프로젝트는?,
What would I say to myself?	나 자신에게 말을 걸어보자.,
What is the best thing about being a college student?	대학생이어서 가장 좋은 점이 있다면?,
What keeps making me tense?	나를 자꾸 긴장시키는 것은?,
Who helps me perform at my best?	내가 최선의 능력을 발휘하도록 이끌어주는 사람은?,
Am I satisfied with the start of the new semester?	새 학기의 시작은 만족스러운가?,
If tomorrow were my last day, what would I do today?	내일이 생의 마지막 날이라면 오늘 무엇을 하겠는가?,
What was my most serious night recently?	요즘 가장 진지했던 밤은?,
What disappeared without warning?	예고도 없이 사라진 것은?,
What was a moment that gave me chills?	전율을 느꼈던 일은?,
Have I found a true teacher?	참된 스승을 찾았는가?,
Is there something I deeply mourn?	깊이 추모해야 할 일이 있다면?,
What advice would I give to a second grader?	초등학교 2학년에게 해주고 싶은 조언은?,
What is currently hot?	요즘 핫(hot)한 것은?,
What kind of frame is hanging in my room?	방에 어떤 액자가 걸려 있는가?,
When did I receive the most considerate treatment?	극진한 대우를 받은 적은 언제인가?,
Is there someone I feel I will definitely meet again someday?	언젠가 꼭 다시 만날 것 같은 사람은?,
Who is enjoyable to talk to these days?	요즘 대화가 즐거운 사람은?,
What gives me energy to study?	공부에 활력을 주는 것은?,
Am I making unforgettable memories?	잊지 못할 추억을 만들고 있는가?,
When did I have an Eureka! moment?	유레카!를 외쳤던 순간은?,
What is my favorite TV show?	가장 좋아하는 TV 프로그램은?,
What is the most recent award or prize I've received?	가장 최근에 받은 상이나 상품은?,
What was the phrase that saved me at a critical moment?	결정적인 순간에 나를 살린 한 마디는?,
When was the last time I exercised?	마지막으로 운동한 것은 언제인가?,
Who do I wish would wait for me?	누가 나를 기다려주면 좋겠는가?,
Who do I want to actively defend?	적극 나서서 변호해주고 싶은 사람은?,
What do I regret not doing in my teenage years?	10대 시절 해보지 않아 후회되는 것은?,
Did I find something I lost?	잃어버린 걸 다시 찾았는가?,
What should I learn from a bad example?	반면교사로 삼아야 할 일은?,
What is the best way to spend a Friday night?	금요일 밤을 보내는 최고의 방법은?,
Who is a friend I can meet comfortably without money?	돈 없이도 편하게 만날 수 있는 친구는?,
What is something I'm glad is very far away?	아주 멀리 있어 다행인 것은?,
Is there something I'm afraid of this week?	이번 주에 두려운 일이 있는가?,
What do I want to trade with a friend?	친구와 맞바꾸고 싶은 것은?,
What have I firmly refused?	단호하게 거절한 것은 무엇인가?,
Where will I live when I am sixty?	예순 살이 되었을 때 나는 어디에 살고 있을까?,
What was the moment when everything was perfect?	모든 게 완벽했던 일은?,
What did I pay the highest price for?	가장 비싼 대가를 치른 일은?,
What was a completely unexpected choice?	완전히 엉뚱한 것을 선택했던 경험은?,
Do I need freedom or a sense of belonging right now?	지금 내게 필요한 건 자유인가,소속감인가?
What is the gift I've kept the longest?	가장 오랫동안 간직하고 있는 선물은?,
What was an inevitable event?	일어날 일은 기어코 일어난다. 그랬던 경험은?,
Have I recently visited another school?	최근 다른 학교에 간 적이 있는가?,
If I start a business, who is the first person I should hire?	창업을 한다고 해보자. 1순위로 영입해야 할 사람은 누구인가?,
Where do I prefer to drink coffee?	어디서 마시는 커피를 가장 좋아하는가?,
I woke up at ____________ this morning. Why?	오늘 ____________시에 일어났다. 그 이유는?,
What do I need to take my time to find an answer for?	천천히 답을 찾아야 할 일은?,
What is a way for an ordinary person to become rich?	평범한 사람이 부자가 될 수 있는 방법은 뭘까?,
What is the largest audience I've stood in front of?	가장 많은 사람 앞에 서본 경험은?,
Who is the most meddlesome person I know?	오지랖이 가장 넓은 사람은?,
What report did I get an A+ on?	A+를 받은 리포트는?,
Am I getting hung up on trivial things?	사소한 것에 목숨 걸고 있지는 않는가?,
When did I feel the greatest betrayal?	가장 큰 배신감을 느꼈던 적은?,
Am I interested in financial management? Why or why not?	재테크에 관심이 있는가? 그렇거나 그렇지 않은 이유는?,
What was a moment when everyone held their breath?	모두가 숨을 죽였던 순간은?,
When did one minute feel like an hour?	1분이 한 시간처럼 느껴졌던 때는?,
What do I keep writing and erasing?	썼다,지웠다 하는 것은?
Who is the most respectable peer among my classmates?	동기들 중 가장 존경스러운 인물은?,
Have I ever drunk during the day? How was it?	낮술을 마신 적 있는가? 어땠는가?,
What needs improvement?	보완해야 할 것은?,
What was the best cramming session?	최고의 벼락치기는?,
If I could change just one thing about today, what would it be?	오늘 하루에 관해 딱 한 가지를 바꿀 수 있다면 무엇을?,
Do I have an embarrassing moment I want to erase completely?	통째로 삭제하고 싶은 흑역사가 있다면?,
What does November mean to my life?	11월은 내 삶에 어떤 의미인가?,
What is currently shining a light on me?	나를 환하게 비추고 있는 것은?,
Have I met someone unexpected?	뜻밖의 사람을 만났는가?,
Have I ever been homeless?	노숙의 경험이 있는가?,
What are my three wishes?	세 가지 소원은?,
What was the most recent text from my parents?	부모님에게 가장 최근에 받은 문자는?,
When do I think I'll get married?	결혼은 몇 살쯤 할 것 같은가?,
Have I ever been caught in a rumor?	소문에 휘말린 적은?,
How many commemorative t-shirts do I have?	기념 티셔츠가 몇 벌 있는가?,
What keeps catching my eye these days?	요즘 자꾸만 눈길이 가는 것은?,
What is my current favorite subject?	현재 가장 관심이 많은 과목은?,
Is there something I want to procrastinate on?	미루고 싶은 일이 있는가?,
What view calms my troubled mind?	어지러운 마음을 편하게 해주는 풍경은?,
When was I blinded by jealousy?	질투에 눈이 멀었던 적은?,
Who bought me a nice dinner?	내게 근사한 저녁을 산 사람은?,
What has returned to the starting point?	원점으로 돌아간 것은?,
Today I wore ____________.	오늘 ____________을(를) 입었다.,
Describe my family in three words.	우리 가족을 세 단어로 표현한다면?,
Who is an artist that inspires me?	내 삶에 영감을 주는 아티스트는 누구인가?,
What is the most recent risk I took?	가장 최근에 위험을 무릅쓴 일은 무엇인가?,
What did I need more of today?	오늘 내게 더 많이 필요했던 것은?,
Is there a story I keep wondering about?	계속 궁금한 이야기가 있는가?,
Look down. What do I see?	아래를 내려다보자. 무엇인 보이는가?,
Rate my current happiness from 1 to 10.	현재 느끼는 행복을 1~10으로 표현한다면?,
Have I ever been stalked or witnessed stalking?	스토킹을 당했거나 목격한 경험이 있는가?,
Am I practicing the Carpe Diem spirit?	카르페디엠 정신을 실천하고 있는가?,
When was I fervently supported?	열렬하게 지지받은 경험은?,
What book did I give up on reading?	읽다가 포기한 책은?,
Am I nurturing the successful me or the failing me?	잘 되는 나와 안 되는 나,어느 쪽에 먹이를 주고 있는가?
What has been completed this year, making me feel relieved?	올해 마무리되어서 속이 시원한 일은?,
What health issue should I watch out for next year?	내년에 유의해야 할 건강은?,
If I could change my major, what would I choose?	전공을 바꿀 수 있다면?,
Am I prioritizing important things?	소중한 것을 먼저 하고 있는가?,
What job might disappear in five years?	5년 안에 사라질 것 같은 직업은?,
How is my current condition?	요즘 나의 컨디션은?,
What year-end party am I looking forward to?	기다려지는 송년 파티는?,
Describe today in five words.	오늘 하루를 다섯 단어로 표현해보자.,
If I move to a new city after graduating, where would it be?	대학 졸업 후 새로운 도시로 간다면 어디로?,
What needs recharging?	재충전해야 할 것은?,
What is my Plan B?	나의 플랜 B는 무엇인가?,
Who is the highest-ranking person I know?	내가 아는 가장 높은 위치에 있는 사람은?,
What field do I want to be the best in?	어떤 분야의 최고가 되고 싶은가?,
Who is a person completely different from their appearance?	생긴 것과는 완전 딴판인 사람은?,
What is the most plausible excuse?	가장 그럴듯한 핑계나 변명은?,
Write a short prayer for myself.	나를 위해 짧은 기도문을 써보자.,
What was the most enjoyable gift I gave this year?	올해 가장 즐거운 마음으로 한 선물이 있다면?,
If I could hug someone right now, who would it be?	지금 당장 누군가를 포옹할 수 있다면?,
What comes to mind first when I open this diary book?	이 다이어리북을 펼친 순간,가장 먼저 떠오르는 것은?
Who contributed the most to my life this year?	올해 내 삶에 가장 기여한 사람은 누구인가?,
Say something to the precious people in my life.	소중한 사람들에게 한 마디 해보자.,
Celebrate myself for finishing this year.	올해를 완주한 나를 축하해보자.,
If I had a boat, what would I name it?	배가 있다면 이름을 무엇으로 지어주고 싶은가?,
Who is a novel character that would be boring to meet in real life?	소설 속 인물 중 실제로 만나면 가장 지루할 것 같은 인물은?,
What was the worst dish I've ever eaten?	여태까지 먹어 본 최악의 요리는?,
What is the worst commercial? Why?	최악의 광고는? 그 이유는?,
What is something magical?	마법에 가까운 것이 있다면 무엇인가?,
What is the most useless talent I have?	내가 가지고 있는 재능 중 가장 쓸모없는 것은?,
Arriving 10 minutes late vs. 20 minutes early?	10분 늦게 도착하기 vs. 20분 미리 도착하기?,
If I had to lose one thing, money vs. photos?	한 가지를 무조건 잃게 된다면 돈 vs. 사진?,
Living surrounded by annoying people vs. living alone forever?	평생 짜증나는 사람들한테 둘러쌓여 살기 vs. 평생 혼자 살기?,
Banning social media vs. banning TV/movies?	SNS 금지 vs. TV/영화 금지?,
Becoming invisible vs. flying?	투명인간 되기 vs. 날기?,
A world without air conditioning vs. a world without heating?	에어콘이 없는 세상 vs. 히터가 없는 세상?,
Having a good voice vs. having good speaking skills?	좋은 목소리 vs. 좋은 말솜씨?,
Visiting the Moon vs. visiting Mars?	달에 가보기 vs. 화성에 가보기?,
Having one eyebrow vs. having no eyebrows? (No makeup allowed)	눈썹이 한 쪽만 남았다 vs. 눈썹이 아예 없다? (화장 불가),
Unlimited coffee vs. unlimited beer?	무제한 커피 vs. 무제한 맥주?,
Genius mathematician vs. genius painter?	천재 수학자 vs. 천재 화가?,
What is the funniest joke I know?	내가 알고 있는 가장 재밌는 농담은?,
What is something invisible that I wish people could see?	보이지 않는 것 중 사람들 눈에 보이기를 바라는 것은?,
Is cereal a soup?	씨리얼은 국인가?,
How many chickens would it take to bring down an elephant?	코끼리를 쓰러뜨리기 위해 몇 마리의 닭이 필요할까?,
Is a hot dog a sandwich?	핫도그는 샌드위치인가?,
A life without friends vs. a life without money?	친구가 없는 삶 vs. 돈이 없는 삶?,
What city did I grow up in?	내가 자라난 도시는?,
Do I look more like my mom or dad?	엄마를 닮았나 아빠를 닮았나?,
Who is my favorite actor?	가장 좋아하는 배우는?,
Who is my favorite singer?	가장 좋아하는 가수는?,
What is my favorite sport?	가장 좋아하는 스포츠는?,
Dog? Cat?	강아지? 고양이?,
What is the animal I fear the most?	가장 무서워하는 동물은?,
How often do I doodle?	낙서를 얼마나 자주 하는가?,
What was the most recent compliment I received?	가장 최근에 들은 칭찬은?,
What are three habits I have?	가지고 있는 습관 3가지는?,
Am I a meticulous person?	나는 세심한 편인가?,
When do I sing?	언제 노래를 부르는가?,
How much do I trust people?	사람을 얼마나 믿는가?,
Is ignorance bliss? Why?	모르는 게 약인가? 왜 그런가?,
If I could change my name, what would I change it to?	이름을 바꿀 수 있다면 무엇으로 바꾸고 싶은가?,
If I could eliminate one weakness, what would it be?	약점을 한 가지 없앨 수 있다면 무엇을 없애겠는가?,
What surprises me?	나를 놀랍게 하는 것은?,
What is my unique persuasive technique?	나만이 가지고 있는 설득의 기술이 있다면?,
What is my characteristic that is rare in others?	다른 사람에게서는 쉽게 볼 수 없는 나만의 특성은?,
What is my friendship style? Narrow and deep? Broad and shallow?	친구관계 스타일은? 좁고 깊은 편? 넓고 얕은 편?,
When have I reached my physical limit?	신체적인 한계에 도달했던 일은?,
Do I tend to avoid conflict?	갈등을 피하는 편인가?,
When was the last time I tried something new?	마지막으로 새로운 것에 도전한 시점은 언제인가?,
If I had three years just for myself, what would I do during that time?	나에게만 3년이 주어진다면 그 기간동안 무엇을 하고 싶은가?,
What is one thing I can teach?	내가 가르칠 수 있는 것 한 가지는?,
What will be most important when I am 80 years old?	80살이 된다면 무엇이 가장 중요해질까?,
What makes me laugh?	나를 웃게 만드는 것은?,
Is it wrong to steal food to feed a starving child?	음식을 훔쳐서 굶고 있는 아이를 먹이는 것은 그른 행위일까?,
What are three moral beliefs I will never break?	내가 절대로 어기지 않을 도덕적 신념 세 가지는?,
What can't be bought with money?	돈으로 살 수 없는 것은?,
If heaven exists, what would it look like?	천국이 존재한다면 어떤 모습일까?,
What makes a person beautiful?	사람을 아름답게 하는 것은?,
What does love feel like?	사랑은 어떤 느낌인가?,
What made me laugh this week?	이번 주에 나를 웃게한 것은?,
What motivates me the most?	나에게 가장 동기부여가 되는 것은?,
What keeps love going?	사랑이 지속되게 하는 것은 무엇인가?,
What is most lacking in my life?	내 인생에서 가장 부족한 것은?,
Who is the celebrity I admire the most?	가장 동경하는 연예인은?,
If the whole world paid attention to me for 30 seconds, what would I say?	전 세계가 나를 30초 동안 주목한다면 무슨 말을 할까?,
What is in my refrigerator?	냉장고 안에 무엇이 있는가?,
If I could eliminate one human invention, what would it be?	인간의 발명품을 한 가지 없앨 수 있다면 무엇을 없애겠는가?,
If I could only say one word for a day, what word would I choose?	하룻동안 하나의 단어만 말할 수 있다면 어떤 단어를 말하겠는가?,
What is a characteristic I like in my friends?	좋아하는 친구의 특성은?,
What is my favorite sound?	가장 좋아하는 소리는?,
What is the dumbest thing I have ever said voluntarily?	자발적으로 한 말 중 가장 바보 같았던 말은?,
What language would I like to learn?	배워보고 싶은 언어가 있다면?,
What is my favorite genre of music?	가장 좋아하는 음악 장르는?,
Where would I like to travel with my friends?	친구들과 가고 싶은 여행지는?,
If I were a flavor, what would I be?	나를 맛에 비유한다면 무슨 맛인가?,
How long can I go without talking?	말을 하지 않고 얼마나 오래 버틸 수 있는가?,
What are three things I want right now?	당장 갖고 싶은 세 가지가 있다면?,
What was something new I tried today?	오늘 처음 시도해본 활동이 있다면?,
Today I needed ___________ more.	오늘 나는 ___________이(가) 좀 더 필요했다.,
If there is something from today I want to erase, what is it?	오늘 있었던 일 중에서 지우고 싶은 기억이 있다면?,
What do I plan to do tomorrow?	내일 무엇을 할 계획인가?,
What is the weather outside right now?	지금 밖의 날씨는 ___________다.,
What time did I go to bed last night?	어제 몇 시에 잠자리에 들었는가?,
If today was an animal, what would it be? Why?	오늘 하루를 동물에 비유한다면? 그 이유는 무엇인가?,
What is something from today I want to change?	오늘 하루 벌어진 일 중에서 바꾸고 싶은 게 있다면?,
What do I regret about today?	오늘 있었던 일 중 후회하는 것은?,
Is my day salty today?	오늘 나의 하루는 짠맛인가,
What is something I never want as a birthday gift?	생일선물로 절대 받고 싶지 않은 것이 있다면?,
What do I want to buy right now?	지금 당장 사고 싶은 것은?,
How did I start my day?	오늘 하루를 어떻게 시작했는가?,
Did I have a recent argument? What was it about?	가장 최근에 말다툼을 한 적이 있는가? 무슨 일 때문이었나?,
How many cups of coffee did I have today?	오늘 커피를 몇 잔 마셨는가?,
Is there a sport I do regularly?	지속적으로 하고 있는 운동이 있는가?,
What was different about today compared to usual?	오늘 평소와 달랐던 점은 ___________다.,
What is my favorite piece of clothing?	가장 좋아하는 옷은?,
What new place have I visited recently?	최근에 가본 새로운 곳은?,
What is my favorite TV show?	가장 좋아하는 TV 프로그램은?,
Write down the name of the person I had the most pleasant conversation with recently.	최근에 기분 좋은 대화를 나눈 사람의 이름을 적어보자.,
What do I usually try to avoid?	평소 피하려고 하는 것은 무엇인가?,
What are my most cherished shoes?	가장 아끼는 신발은?,
Do I prefer summer?	여름이 좋은가,
What am I currently reading?	현재 읽고 있는 글이나 책이 있다면?,
What song is stuck in my head?	계속 머릿속에 맴도는 노래가 있다면?,
Where do I want to travel next?	다음에 여행하고 싶은 곳은 어디인가?,
What was the last book I read?	마지막으로 읽은 책은?,
Where do I feel most comfortable?	가장 편안하게 느껴지는 장소는?,
What is my secret to a happy Sunday morning?	일요일 오전을 행복하게 보내는 나만의 비법은?,
What was the most impressive quote I read today?	오늘 읽은 가장 인상적인 글귀는?,
What is my favorite word?	가장 좋아하는 단어가 있다면?,
Create an acrostic poem with my name.	내 이름으로 삼행시를 지어보자.,
What gift do I want to give myself?	나에게 주고 싶은 선물이 있다면?,
What is the first thing I want to do if I win the lottery?	로또에 당첨되면 가장 먼저 하고 싶은 일은?,
What is my favorite accessory?	가장 좋아하는 액세서리는?,
What dish am I most confident in making?	가장 자신 있게 만들 수 있는 요리는?,
What was the most impressive dream I've had recently?	최근 꾼 꿈 중에 인상적인 것은?,
Is there something I'm eagerly waiting for?	몹시 기다려지는 일이 있는가?,
What was the last TV show I watched?	마지막으로 본 TV 프로그램은?,
What was the last concert or performance I attended?	마지막으로 가본 공연이나 콘서트는?,
What is my favorite word at this moment?	(지금 이 순간) 가장 좋아하는 단어는?,
What was the last song I listened to?	마지막으로 들은 노래는?,
___________ made me laugh.	___________이(가) 나를 웃게 했다.,
What is an indispensable human invention for me?	나에게 없어는 안 되는 인류의 발명품은?,
Was today enjoyable? Why?	오늘 하루 즐거웠는가? 그 이유는?,
What news made me happiest today?	오늘 나를 가장 기쁘게 한 소식은 무엇인가?,
What new fact did I learn today?	오늘 새롭게 알게 된 사실을 적어보자.,
Write down one problem I solved today.	오늘 해결한 문제를 한 가지만 적어보자.,
Who do I want to call right now?	지금 당장 전화를 걸고 싶은 사람은?,
If my life were a movie, who would play me?	내 인생을 영화로 만든다면 주인공 역은 누구로 하고 싶은가?,
What is my favorite day of the week? Why?	무슨 요일을 가장 좋아하는가? 그 이유는?,
Today I eliminated ___________.	나는 오늘 ___________을(를) 제거했다.,
What motivated me today?	오늘 나에게 동기를 부여해준 일은?,
If I could travel anywhere tomorrow, where would I go?	내일 어디든 여행할 수 있다면 가장 가고 싶은 곳은?,
What would I do with a day off?	하루의 휴가가 주어진다면 무엇을 하고 싶은가?,
What am I grateful for today?	오늘 감사하게 생각하는 일은?,
What is my happiest way to spend a Friday night?	금요일 밤을 보내는 나만의 가장 행복한 방법은?,
Is there a goal I want to achieve within a month?	한 달 안에 이루고 싶은 목표가 있는가?,
What was the best time of my day?	오늘 가장 좋았던 시간은 언제인가?,
Has someone cooked for me recently?	누군가 나를 위해 요리해준 적이 있는가?,
Who sent me the last handwritten letter?	가장 최근에 받은 손편지는 누구에게서 온 것인가?,
When was the last time I laughed a lot?	최근에 가장 많이 웃었던 적은?,
What makes me emotional?	나를 감성에 젖게 만드는 것은?,
Did something hurt me today?	오늘 상처받은 일이 있는가?,
Where do I go to brainstorm good ideas?	좋은 아이디어를 떠올려야 할 때 찾는 곳은?,
Is there someone I want to approach and talk to?	무작정 다가가 말을 걸고 싶은 사람이 있는가?,
Describe myself in one word.	나를 한 단어로 표현한다면?,
What is my happiest way to spend a Saturday morning?	토요일 오전을 보내는 나만의 가장 행복한 방법은?,
What part of my body do I like the most?	내 몸 중에서 가장 마음에 드는 곳은?,
If I were to be imprisoned for five years, what would I want to do the day before?	5년 동안 교도소에 갇히게 된다면 입소 전날 무엇을 하고 싶은가?,
When imagining the future, do I envision the best or the worst case?	앞으로 일어날 일을 상상할 때 최선의 경우를 떠올리는 편인가, 최악의 경우를 떠올리는 편인가?,
Do I have a way to instantly boost my mood?	당장 기분을 좋게 하는 비법이 있는가?,
What advice would I give to a second grader?	초등학교 2학년생에게 해주고 싶은 조언은?,
What was the most shocking news I heard recently?	최근에 들은 충격적인 소식은?,
Do I rely more on logic or intuition?	논리보다 직감에 의존하는 편인가?,
Am I good at declining unreasonable requests?	사람들의 무리한 부탁을 잘 거절하는 편인가?,
Do I prefer hearing good news or bad news first?	좋은 소식과 나쁜 소식 중에 무엇을 먼저 듣고 싶은가?,
What is my method for changing my mood?	나만의 기분 전환 방법은?,
Is there a field I am crazy about?	광적으로 좋아하는 분야가 있다면?,
What is my biggest dream?	나의 가장 큰 꿈은 무엇인가?,
I want a new ___________.	나는 새로운 ___________을(를) 원한다.,
If I could express today in one word, what would it be?	오늘 하루를 한 단어로 표현한다면?,
Which famous person do I want to have a drink with?	현존하는 유명인 중에서 술 한잔하고 싶은 사람은?,
Who do I trust and rely on?	내가 믿고 의지하는 사람은?,
Have I made any verbal blunders recently?	최근에 한 말실수가 있다면?,
Can I honestly tell someone if I can no longer tolerate their behavior?	누군가의 행동을 더 이상 참기 어려울 때 사실대로 말할 수 있는가?,
What do I hope will never change?	앞으로도 쭉 변하지 않았으면 하는 것은?,
What is the best compliment I could hear?	가장 듣기 좋은 칭찬은?,
What song represents me well?	나를 잘 나타내주는 노래는?,
What surprised me today?	오늘 나를 놀라게 한 것은?,
How long do I want to live?	몇 살까지 살고 싶은가?,
Staying in and lounging vs. going out and playing?	집 안에서 뒹굴거리기 vs. 밖에 나가서 놀기?,
What do I most want to part with in my life?	내 삶에서 가장 결별하고 싶은 것은?,
What is my favorite question to ask people?	사람들에게 가장 즐겨하는 질문은 무엇인가?,
Name one item I can never throw away.	절대로 버릴 수 없는 물건을 하나만 적어보자.,
If I had an extra hour every day, what would I do?	하루에 한 시간이 늘어난다면 뭘 할까?,
When was the last time I felt peak happiness?	마지막으로 절정의 행복을 느꼈을 때는 언제인가?,
Describe today in a color.	오늘을 색깔로 표현해보자.,
Write a poem or song lyrics that fit today.	오늘 하루와 어울리는 시와 노래 구절을 적어보자.,
What is something I must do before I die?	죽기 전에 꼭 하고 싶은 일이 있다면?,
If I could gain one talent effortlessly, what would it be?	(노력 없이) 한 가지 재능을 얻을 수 있다면 무엇을 고르겠는가?,
Describe today in three words.	오늘 하루를 세 단어로 표현한다면?,
If I could have a superpower for a day, what would I want?	하루 동안 초능력을 가질 수 있다면 어떤 것을 원하는가?,
Which literary character do I want to emulate?	닮고 싶은 문학작품 속 주인공은?,
What is my biggest strength?	나의 가장 큰 장점은?,
Write down three characteristics that define me.	나를 이루고 있는 특징 세 가지를 적어보자.,
What is my dream job?	내가 생각하는 꿈의 직장은?,
Describe my current mood in five words.	지금 기분을 다섯 글자로 표현한다면?,
What is my idea of a perfect vacation?	내가 생각하는 환상적인 휴가는?,
Do I consider myself lucky?	나는 운이 좋은 편이라고 생각하는가?,
Who inspired me enough to change my life?	내 인생을 바꿀 만한 영감을 준 사람이 있다면?,
Do I feel I need a break? From what?	휴식이 필요하다고 느끼는가? 무엇으로부터?,
What do I think of as home?	집이란 무엇이라고 생각하는가?,
What is my method for healing a wounded heart?	상처받은 마음을 치유하는 나만의 방법을 적어보자,
What word did I overuse today?	오늘 지나치게 많이 사용한 말은?,
What was my most prominent emotion today?	오늘 가장 두드러진 감정은 무엇인가?,
There was too much ___________ today.	오늘 ___________이(가) 지나치게 많았다.,
What question would I ask my mother?	어머니에게 하고 싶은 질문은?,
Is there something I never want to tell anyone?	아무에게도 하고 싶지 않은 이야기가 있는가?,
Why do I work?	나는 왜 일하는가?,
What was the most absurd thought I had today?	오늘 떠올린 생각 중에 가장 엉뚱한 것은?,
What memory from today do I want to keep?	오늘 하루 중 기억에 남기고 싶은 것은?,
Is there a hidden passion I have?	남모르게 간직한 열정이 있다면?,
If I had to choose one person to share my secrets with, who would it be?	비밀을 털어놓을 수 있는 사람을 한 명만 꼽는다면?,
What is my biggest flaw?	나의 가장 큰 단점은 무엇인가?,
If I could have dinner with a famous deceased person, who would it be?	세상을 떠난 유명인 중에서 저녁식사를 함께하고 싶은 사람은?,
If I could swap lives with someone for a day, who would it be?	딱 하루만 인생을 바꿀 수 있다면 누구와 바꾸겠는가?,
Do good enemies exist?	좋은 적이란 과연 존재할까?,
What was my most fulfilling achievement?	지금까지 이룬 것 중 성취감이 가장 컸던 일은?,
If I could take a time machine to change one thing in the past, what would it be?	타임머신을 타고 과거로 돌아가 꼭 바꾸고 싶은 일이 있다면?,
Whose death affected me the most?	주변인의 죽음 중 가장 슬펐던 사람은?,
Do I trust my instincts?	직감을 믿는 편인가?,
Who do I miss the most right now?	지금 이 순간 가장 그리운 사람은?,
What makes me cynical?	나를 냉소적으로 만드는 것은?,
If I were to predict my mood like the weather, what would it be?	날씨 예보처럼 기분을 예측한다면 앞으로 내 기분은 ___________다.,
If I could have any job for a day, what would it be?	딱 하루만 원하는 직업으로 살 수 있다면 무엇을 선택하겠는가?,
___________ is perfect.	___________은(는) 완벽하다.,
What do I need to let go of?	내가 버려야 할 것은 무엇인가?,
Am I earning enough money?	나는 돈을 충분히 버는가?,
What is my favorite question to answer? (Can be more than one)	가장 답하기 좋아하는 질문은 무엇인가? (하나 이상 가능),
Describe today in 140 characters or less.	오늘 하루를 140자 내외로 표현해보자.,
What is the most satisfying part of my life right now?	현재 삶에서 가장 만족스러운 부분은?,
Am I a teacher or a learner?	나는 가르치는 사람인가, 배우는 사람인가?,
What will I be like in five years?	나는 5년 후에 어떤 모습일까?,
Today I learned ___________.	오늘 배운 것은 ___________다.,
What do I think of when I hear 'fear'?	두려움 하면 떠오르는 것은?,
What am I chasing right now?	지금 이 순간 무엇을 좇고 있는가?,
Name a small but chronic problem.	사소하지만 고질적인 문제를 하나 적어보자.,
I have no patience for ___________.	나는 ___________에 인내심이 없다.,
___________ is just nonsense.	___________은(는) 정말 말도 안 된다.,
I almost ___________ today.	오늘 거의 ___________할 뻔했다.,
Do I want to know how my end will be?	나의 마지막이 어떨지 알고 싶은가?,
How much money do I need to be happy?	재산이 얼마나 있으면 행복할까?,
Why am I amazing?	내가 대단한 이유는?,
What is something I can't resist?	거부할 수 없는 것은?,
If I could move to a new place, which city would it be?	새로운 곳으로 이사한다면 어느 도시로 가고 싶은가?,
What is my idea of a peaceful scene?	내가 생각하는 가장 평화로운 장면은?,
What makes me who I am?	무엇이 나를 나답게 만드는가?,
Friends are ___________.	친구란 ___________다.,
What is the greatest job in my opinion?	가장 위대하다고 생각하는 직업은?,
What is the best way to spend 10,000 won?	만 원을 가장 알차게 쓸 수 있는 방법은 무엇일까?,
Who is a famous person I want to interview?	인터뷰하고 싶은 유명인사는?,
What makes a good friend?	좋은 친구란 무엇일까?,
If I wrote an autobiography, what would be the first sentence?	자서전을 쓴다면 첫 문장을 어떻게 쓰고 싶은가?,
What are my three wishes?	소원 세 가지는?,
What is the purpose of my life?	내 삶의 목적은 무엇인가,
Can people change?	사람은 변할 수 있는가,
Do I think I can love one person my whole life?	평생 한 사람만 사랑하면서 살 수 있다고 생각하는가?,
Ultimately, what kind of person do I want to be?	궁극적으로 어떤 사람이 되고 싶은가?,
What is the biggest obstacle blocking my dream?	현재 나의 꿈을 가로막는 가장 큰 장애물은 무엇인가?,
What makes me unhappy?	나를 불행하게 만드는 것은?,
What am I bound to lose?	내가 잃을 수밖에 없는 것은?,
What is needed for a perfect day?	완벽한 하루를 위해서는 무엇이 필요한가?,
What do I want on my tombstone?	내 묘비에 남기고 싶은 말은?,
What are three key terms in my life right now?	현재 내 삶의 중요한 키워드 세 가지는?,
What are the conditions for being professional in my opinion?	내가 생각하는 프로페셔널의 조건은?,
What would be relieving to hear?	들으면 속이 후련해질 것 같은 말은?,
What are the unique privileges of being in my twenties?	오직 20대에만 누릴 수 있는 특권은 무엇일까?,
What is my soul food?	나의 소울 푸드는 무엇인가?,
What is my new interest?	새로운 관심사는 무엇인가?,
What was the most recent restaurant I visited? What did I eat?	가장 최근에 방문한 식당은? 무엇을 먹었는가?,
Today was difficult because _______________.	오늘 하루가 힘들었던 이유는 _______________다.,
Was today an ordinary day? Why or why not?	오늘은 평범한 하루였는가? 그렇거나 그렇지 않은 이유는?,
Today I lost ____________.	나는 오늘 ____________을(를) 잃었다.,
Am I a leader?	나는 리드하는 쪽인가,
Do I have any borrowed or lent money?	빌리거나 빌려준 돈이 있는가?,
What is the oldest piece of clothing I wore today?	오늘 입은 옷차림 중에서 가장 오래된 것은?,
If I start a business, what would I want to do?	만약 창업을 한다면 어떤 일을 하고 싶은가?,
Do I prioritize safety?	안전을 추구하는가,
If I express today's me as an art movement? (Surrealism,	오늘의 나를 예술 사조로 표현한다면? (초현실주의,
Who do I live with?	누구와 함께 사는가?,
Was there something sad today? Rate the intensity from 1 to 10.	오늘 하루 슬퍼할 일이 있었는가? 그 강도를 1~10으로 표현한다면?,
What did I commute with today? Walking? Subway?	오늘 무엇을 타고 출근했는가? 걸어서? 지하철을 타고?,
Am I in love right now?	지금 사랑하고 있는가?,
What is the most expensive thing I'm wearing right now?	지금 몸에 걸친 것 중에서 가장 비싼 물건은?,
Who is the craziest person I know?	내가 아는 가장 정신 나간 사람은 누구인가?,
List three trendy words these days.	요즘 유행하는 말을 세 개만 적어보자.,
What did I desperately want today but couldn't get?	오늘 하루 간절히 원했지만 얻지 못한 것이 있다면?,
Am I an original person?	나는 독창적인 사람인가,
When was the last time I was sick?	마지막으로 아팠던 적은 언제인가?,
Who is my enemy?	나의 원수는 누구인가?,
It's not a good idea to experiment with ___________.	___________을(를) 실험하는 것은 좋은 생각이 아니다.,
Today I wanted to ignore ___________.	오늘 무시하고 싶었던 사람은 ___________다.,
What is the most recent movie I've watched?	가장 최근에 본 영화는?,
What is an undeniable fact?	부인할 수 없는 팩트(fact)는 무엇인가?,
What do I pray for?	무엇을 위해 기도하는가?,
What was the first thing I ate today?	오늘 가장 먼저 먹은 음식은?,
Write down a news article for today.	오늘의 뉴스 기사를 하나 적어보자.,
Do I prefer ballads or dance music?	발라드와 댄스 중에 어떤 음악을 선택하겠는가?,
What is the biggest lie I told that had a major impact?	내가 한 거짓말 중에 가장 큰 파장을 불러일으켰던 것은?,
What do I hope will happen today?	오늘 일어나기를 바라는 일은?,
What was the most recent takeout food I ordered?	가장 최근에 주문한 테이크아웃 음식은?,
What color clothes am I wearing now?	지금 어떤 색깔의 옷을 입고 있는가?,
What housework did I skip today?	오늘 빼먹은 집안일은 ___________다.,
How many times did I swear today?	오늘 욕을 몇 번이나 했는가?,
What do I say when someone asks what I do?	누군가 무슨 일을 하냐고 물을 때 뭐라고 답하는가?,
What is something I hope never happens?	절대 일어나지 않았으면 하는 일은?,
What do my parents think of me? (I can call and ask.)	부모님은 나를 어떻게 생각하실까? (전화해서 여쭤봐도 된다.),
Do I think life is fair? Choose one of the four options. (It is fair,	인생은 공평하다고 생각하는가? 다음 넷 중에 골라보자. (공평하다,
How much money is in my wallet right now?	현재 지갑에 돈이 얼마나 있는가?,
Am I an emotional person or a rational person?	나는 감성적인 사람인가,이성적인 사람인가?
Who can I make happy?	내가 행복하게 만들어줄 수 있는 사람은 누구일까?,
Do I have a favorite flower or plant?	가장 좋아하는 꽃이나 식물이 있다면?,
Am I a neat person or a messy person?	나는 깔끔한 사람인가,지저분한 사람인가?
When was the last time I swam?	마지막으로 수영을 한 적은 언제인가?,
Today was really exciting. Why?	정말 신나는 하루였다. 그 이유는 ___________다.,
What do I want to say to my mother?	어머니에게 하고 싶은 말은?,
What is something I want to procrastinate on today?	오늘 해야 할 일 중 미루고 싶은 일은 무엇인가?,
What was the most creative thing I did recently?	최근에 한 가장 창의적인 일은?,
Is there a field I'm currently exploring?	현재 탐구하고 있는 분야가 있다면?,
Who showed me affection today?	오늘 나에게 애정을 보여준 사람은?,
What was the last meeting I attended?	마지막으로 참석한 모임은?,
What is my current hairstyle?	현재 나의 헤어스타일은?,
Write down the things that troubled me today.	오늘 나를 괴롭힌 일들을 적어보자.,
What gives me comfort now?	현재 나에게 위안을 주는 것은?,
Do I prefer mountains or the sea?	산과 바다 중 어느 곳이 더 좋은가?,
Rate my health from 1 to 10.	나의 건강 상태를 1~10으로 나타낸다면?,
Today I wore ___________.	오늘은 ___________을(를) 입었다.,
What was the last fruit I ate?	마지막으로 먹은 과일은 무엇인가?,
Who is the closest person in my family?	가족 중 가장 가까운 사람은?,
What worried me today?	오늘 나를 걱정하게 만든 것은 ___________다.,
What is my favorite electronic device?	가장 좋아하는 전자기기는?,
Is there someone I want to get closer to?	더 가까워지고 싶은 사람이 있다면?,
What was the last movie I watched in a theater?	가장 최근에 영화관에서 본 영화는?,
When was the last time I cried?	마지막으로 울었던 적은 언제인가?,
What is an upcoming event or gathering I need to attend?	조만간 참여해야 하는 모임이나 행사는?,
Do I think war will break out?	전쟁이 일어날 것이라고 생각하는가?,
When was the last time I ate pizza? What kind was it?	마지막으로 피자를 먹은 적이 언제인가? 어떤 피자였는가?,
How much can I drink?	주량이 얼마나 되는가?,
What was the last sea I visited?	마지막으로 가본 바다는?,
What did I cancel today?	오늘 취소한 일은 ___________다.,
Love vs. friendship?	사랑과 우정 중에 하나를 고른다면?,
___________ is fun.	___________은(는) 재미있다.,
What is my motto?	나의 신조는 무엇인가?,
Why was today pleasant?	오늘이 유쾌했던 이유는 ___________다.,
When was the last conversation I had with my parents?	부모님과 마지막으로 대화를 나눈 적은 언제인가?,
What is my Achilles' heel?	나의 아킬레스건은 무엇인가?,
Am I wearing socks right now?	지금 양말을 신고 있는가?,
What was the last meal I cooked?	가장 최근에 만든 요리는?,
Which past or present artist would I ask for a portrait?	(과거 또는 현존하는) 화가 중에서 초상화를 부탁하고 싶은 사람은?,
Am I diligent or do I tend to slack off?	성실하게 일하는 편인가,꾀를 부리는 편인가?
What do I smell right now?	지금 무슨 냄새가 나는가?,
Today was difficult because _______________.	오늘 하루가 힘들었던 이유는 _______________다.,
What is my way to beat the heat?	더위를 피하는 나만의 방법은?,
Do I prefer showering with cold or hot water?	차가운 물로 샤워하는 게 좋은가,뜨거운 물로 샤워하는 게 좋은가?
Describe where I am right now.	지금 있는 곳을 묘사해보자.,
If I were Pinocchio, how long would my nose be right now?	내가 피노키오라면 나의 코는 지금 얼마나 길어졌을까?,
When was the last time I took a flight?	가장 최근에 비행기를 탄 적은?,
Today I broke ___________.	오늘 내가 망가뜨린 것은 ___________다.,
What was the most delicious meal I had recently?	최근에 가장 맛있었던 식사는?,
What was the last text message I sent?	마지막으로 보낸 문자 메시지를 적어보자.,
Is there something I want to escape from right now?	지금 도망치고 싶은 일이 있다면?,
What do I eat first at a buffet?	뷔페에서 가장 먼저 먹는 음식은?,
Did I finish everything I needed to do today?	오늘 해야 할 일을 모두 끝마쳤는가?,
What bothered me the most today?	오늘 나를 가장 신경 쓰이게 한 것은 ___________다.,
What team am I part of?	나는 어느 팀에 소속되어 있는가?,
Is there a food I can eat every day without getting tired of it?	매일 먹어도 질리지 않는 음식이 있다면?,
What are the elements needed to foster creativity?	창의성 발휘에 필요한 요소를 적어보자.,
What do I want to say to my father?	아버지에게 하고 싶은 말은?,
When was the last time I exercised?	마지막으로 운동한 것은 언제인가?,
Do I have a victory slogan?	나만의 승리 구호가 있다면?,
What did I eat for dinner?	오늘 저녁으로 뭘 먹었는가?,